1 6 44 87 106 115
2 11 15 24 34 36 42 46 47 50 63 67 69 84 120
3 21 24 35 52 97 116 118
4 1 16 32 47 61 91
5 8 9 13 20 22 23 25 28 31 38 39 41 42 51 55 56 57 63 65 73 78 83 85 86 87 99 103 106 107 109 110
6 5 8 24 30 54 71 75 93 120
7 2 4 8 11 12 18 19 20 21 22 24 25 26 30 31 34 42 45 46 47 48 49 50 51 54 56 57 58 59 62 66 67 68 69 72 73 76 78 79 80 82 83 86 87 96 98 100 101 103 106 108 111 119 120
8 1 5 19 29 53 58 83 88 92 97 99 101 107 117
9 18 21 22 29 32 33 37 46 47 51 55 57 58 64 71 80 81 82 95 98 100 102 103 105 106 109 111 115 117 119
10 1 2 6 8 11 16 23 26 28 29 30 34 35 38 42 45 56 59 60 65 66 68 72 73 74 76 84 91 105 107 110 112
11 3 4 12 17 20 26 27 38 39 51 55 64 66 67 69 70 72 91 100 106 113
12 9 31 49 59 72 88 95 112
13 11 15 17 28 29 34 43 49 52 55 57 58 74 77 83 90 114
14 46 59 64 71 77 80 84 86 95 99 109
15 1 3 4 5 6 8 9 10 11 16 25 26 28 29 31 33 34 38 42 47 48 49 51 52 55 56 57 64 65 67 69 73 74 79 81 82 83 85 86 88 90 92 95 97 99 100 107 109 110 112 115 118 119 120
16 8 28 37 43 118
17 6 14 64
18 3 5 6 10 11 12 13 14 17 19 20 21 22 24 25 29 30 32 33 34 36 37 38 39 40 42 43 44 45 49 50 53 59 60 62 63 65 66 67 69 70 71 72 73 74 76 78 85 86 88 89 90 93 94 96 100 103 105 106 107 108 110 111 114 115 116 118 119 120
19 1 2 3 16 21 23 28 30 33 39 46 49 50 52 58 60 61 72 82 87 93 96 103 104 106 107 114 115
20 1 5 8 9 17 27 28 29 30 39 42 43 44 45 46 47 48 51 55 56 58 62 64 71 73 80 81 83 88 89 93 98 100 103 105 107 112 114 115 116 119
21 76 101 112 117 118
22 3 4 7 9 12 13 14 15 16 17 19 21 24 25 26 28 30 31 32 33 34 38 39 41 42 47 50 51 53 54 55 57 58 60 61 62 63 65 67 71 72 74 76 77 79 82 83 84 85 86 88 89 90 91 92 93 94 95 96 97 99 101 102 106 107 109 110 115 117 118 119
23 1 11 16 19 34 41 47 48 54 56 58 65 66 67 80 84 92 97 100
24 1 10 23 28 49 56 58 70 87 92 97 98 105 106 115 116
25 2 5 15 26 34 60 61 70 74 76 84 86 88 114
26 20 73
27 21 47
28 54 79 95 117
29 4 6 7 13 16 18 19 25 27 35 36 37 42 46 47 49 52 55 56 59 61 66 70 73 75 82 83 84 87 88 92 94 103 107 110 111 112 118
30 2 4 6 7 12 13 16 18 21 22 24 25 31 32 33 40 42 43 45 46 47 57 58 61 68 69 71 74 76 79 82 85 87 92 93 94 96 99 100 101 103 107 110 112 115 117 119
31 8 12 16 17 18 27 30 39 45 46 51 52 54 56 58 59 63 71 72 78 84 85 88 90 97 99 100 101 103 107 108 115 117 119 120
32 2 3 4 5 6 7 8 10 11 13 14 16 21 22 24 26 27 28 29 33 36 37 39 40 43 44 46 47 51 52 53 57 58 59 61 62 63 65 68 69 70 72 73 75 78 80 81 82 85 88 89 91 93 94 96 98 101 102 104 105 106 107 108 109 113 114 115 116 118 119 120
33 1 2 6 7 8 9 10 12 13 14 15 16 17 18 20 21 22 23 24 25 26 27 28 29 30 32 34 35 36 37 40 41 42 43 44 45 46 47 48 51 52 55 56 57 59 60 61 62 64 65 66 67 68 71 72 73 74 76 77 78 79 83 85 86 88 89 90 92 93 94 95 96 97 98 100 101 102 103 106 109 110 111 112 113 114 116 118 119 120
34 1 7 13 24 29 32 35 37 66 80 89 92 93 95 98 99
35 1 2 4 5 6 8 9 10 11 12 13 14 15 16 17 18 19 20 21 22 23 25 26 27 28 29 30 31 32 33 34 36 37 38 39 41 42 45 46 47 48 49 50 51 52 53 54 55 56 57 59 60 61 62 63 64 66 68 69 70 71 72 73 74 75 76 79 80 81 82 83 84 85 86 87 88 89 91 92 93 95 96 98 100 101 102 103 104 105 106 107 108 110 111 112 113 114 115 116 118 119 120
36 9 13 14 18 22 30 31 32 34 37 39 40 42 43 47 48 50 59 60 64 72 73 74 89 90 92 98 99 100 102 103 114
37 15 22 78
38 2 3 8 9 11 12 13 16 24 25 33 34 40 41 44 47 49 55 56 65 66 70 72 74 75 76 79 82 88 90 91 92 97 100 103 106 110 112 115 120
39 7 8 15 18 19 24 25 26 27 32 33 37 41 42 51 53 56 57 61 66 73 91 92 95 100 103 115 116 118 119
40 1 9 10 16 18 23 32 37 43 47 52 56 61 67 71 80 88 89 99 101 103 108 111 114 115 116
41 2 3 18 20 21 22 26 28 33 34 37 39 46 51 53 55 56 59 65 68 76 82 85 86 90 97 98 99 100 101 119
42 27 60 65 86 98 116 119
43 1 9 11 14 16 18 22 23 24 26 28 29 30 35 36 44 46 48 60 62 69 70 73 81 82 87 92 94 100 105 111 114 119 120
44 1 2 6 7 8 10 14 20 24 26 27 31 32 36 37 38 42 47 49 52 54 55 56 63 64 66 69 71 79 84 85 86 90 92 94 98 99 104 106 108 109 111 112 114 116 117
45 6 7 38 41 78 84 99 114
46 7 15 24 28 36 38 42 43 47 54 60 75 81 95 98 104 109 115
47 1 3 5 7 9 11 16 19 22 23 29 30 34 37 41 46 48 53 55 61 62 80 81 83 86 92 93 94 101 104 109 114 116 117 118
48 1 3 4 6 11 13 15 16 20 24 25 27 28 34 36 39 41 43 46 53 55 56 59 69 72 73 79 80 82 87 95 97 105 106 107 108 109 118 119
49 5 11 23 24 31 33 37 65 91 96 100 108
50 12 17 18 19 28 29 30 31 33 35 36 41 45 53 58 60 62 67 68 70 89 95 96 98 104 105 106 108 110 115
51 2 5 6 8 9 13 16 17 20 21 24 28 31 33 37 46 48 53 57 59 62 63 64 68 71 73 74 75 77 80 82 83 84 85 90 91 93 94 102 106 114 117 118
52 3 4 6 7 8 11 16 19 21 22 23 24 28 29 31 32 35 36 38 39 41 46 47 48 49 51 56 57 58 60 63 69 70 75 77 78 79 80 83 86 88 89 94 100 105 106 107 108 109 115 117 118 119 120
53 3 14 16 29 30 42 49 50 54 65 70 72 73 75 76 78 81 84 89 94 95 96 109 113 118 120
54 1 2 3 4 5 7 9 10 11 14 15 16 17 18 19 20 21 22 24 25 26 29 30 31 35 39 40 41 44 46 47 48 49 50 51 52 53 55 57 58 61 62 63 68 69 73 74 76 77 79 81 82 84 85 86 87 88 89 90 91 92 93 95 97 101 104 105 107 108 112 117 120
55 102 107
56 6 68
57 13 16 31 37 40 54 59 64 75 84 94 97
58 5 11 14 20 23 25 27 30 37 43 66 68 70 72 77 80 81 87 88 94 96 97 100 107 111 113 119
59 3 32 52 64 91 95 115
60 1 2 5 6 8 9 10 11 13 15 19 20 23 24 25 29 32 33 34 36 37 38 40 42 43 44 46 47 49 52 53 55 58 59 61 63 64 65 66 67 69 70 71 72 74 75 76 77 83 85 87 88 89 90 92 93 95 97 99 100 102 104 105 106 107 108 110 111 112 113 114 119 120
61 4 6 8 14 24 27 29 32 34 43 45 46 49 55 60 62 66 68 73 76 84 88 98 100 103 111 115 117 118
62 4 15 33 38 42 56 72 77 78 85 86 88 91 92 94 99 102 108 110
63 1 3 10 12 13 18 29 33 35 37 41 43 47 49 51 52 54 59 60 66 68 73 77 78 86 88 89 93 97 103 104 108 112 114 115 118
64 4 5 6 7 8 9 11 17 18 19 20 21 23 25 28 30 31 33 34 37 39 40 41 44 45 46 47 48 50 51 52 53 55 56 59 60 61 62 66 70 74 78 79 82 83 84 86 89 91 95 98 99 100 104 107 114 115 117 118
65 33 55 63 69 75 85 98 117
66 29 41 61 69 81 89 94 98 106 110
67 15 23 115
68 1 2 3 4 5 6 7 8 9 10 11 12 13 14 15 16 17 19 20 21 22 23 24 25 26 27 28 29 30 31 32 33 34 35 36 37 38 39 40 41 42 43 44 46 47 48 49 50 51 52 53 54 55 56 57 58 59 60 62 63 64 65 66 67 69 70 71 72 73 74 75 76 77 78 79 80 81 82 83 84 85 86 88 89 90 91 92 93 94 95 96 97 98 99 100 101 102 103 104 105 106 107 108 109 110 111 112 113 114 115 116 117 118 119 120
69 16 21 38 45 47 48 53 63 72 77 83 87 93 95 107 117
70 5 6 7 8 12 19 24 26 36 37 39 43 44 45 49 50 51 52 54 56 59 60 61 63 78 81 82 83 84 86 87 88 93 96 98 103 108 112 114 116 119 120
71 2 3 4 5 6 7 8 9 11 12 14 15 16 17 18 20 22 24 25 26 27 29 30 31 32 33 34 35 38 39 40 41 43 44 46 47 48 49 50 51 52 57 58 59 60 62 64 65 66 67 68 70 72 74 75 77 79 80 81 82 84 87 88 89 91 92 93 94 96 98 100 101 104 105 106 107 108 110 111 112 113 116 117 118 119 120
72 12 56 70 76 94 95 102
73 22 41 60 80 110
74 2 10 11 13 14 16 17 19 21 26 27 28 29 35 36 37 40 41 42 43 44 46 49 50 52 55 59 62 64 65 66 70 71 76 78 79 81 82 83 85 86 90 91 92 94 96 97 98 100 105 113 114 115 116 117 118
75 1 4 8 11 12 15 19 20 23 29 32 34 36 37 41 44 48 49 51 52 58 60 61 63 65 66 67 68 69 70 72 74 77 79 87 90 92 93 94 98 101 102 103 105 107 110 111 120
76 2 4 6 7 11 12 13 18 24 25 28 38 42 45 47 48 49 50 60 62 65 66 69 84 85 86 87 90 93 98 101 106 112 114 116 117 119 120
77 2 3 4 5 6 7 8 10 12 13 15 16 17 18 19 21 22 25 26 28 32 33 34 35 37 39 40 42 43 46 48 51 52 53 54 57 59 60 62 63 64 65 66 69 71 73 74 76 80 81 82 84 85 86 87 89 91 92 98 99 101 104 105 108 110 111 112 115 117 119 120
78 1 5 6 8 11 14 18 19 21 26 27 34 36 39 44 45 50 52 54 57 60 70 71 73 74 84 86 89 93 95 97 100 101 104 105 106 112 113 114 120
79 5 7 8 10 15 16 18 20 26 27 29 30 32 36 38 42 43 44 46 47 49 50 53 60 64 71 72 74 75 81 82 89 95 100 103 106 113 117
80 2 5 6 11 12 16 22 25 26 27 35 38 39 41 45 46 47 48 49 57 60 67 76 77 83 86 88 93 95 98 102 104 105 107 111 115 116 118
81 2 3 4 8 11 14 15 17 18 20 21 22 23 24 26 29 32 33 34 39 40 42 46 48 49 51 55 58 61 69 72 73 74 75 76 84 85 87 90 91 93 94 98 101 104 105 107 108 110 111 112 113 114 116 117 118 119
82 7 10 64 66 110 116
83 11 54 59 67 75 86 94 102
84 8 13 16 17 21 34 35 36 45 50 58 64 65 69 81 83 85 87 91 92 94 105
85 6 20 25 29 30 32 34 43 103
86 2 7 8 9 16 23 33 35 36 39 57 64 71 74 77 79 91 93 99 111 116
87 27 30 39 103 114 117 118
88 4 5 9 12 15 21 24 25 27 30 31 32 33 34 35 36 39 40 41 42 43 45 47 50 53 54 55 59 60 63 64 65 72 74 75 78 79 80 83 84 86 90 93 94 95 96 97 98 99 101 104 106 108 109 110 111 112 113 115 116 117 118 119 120
89 14 16 26 46 47 54 70 74 79 95 96 107
90 34 38 50 55 58 70 74 80 88 102 105 111 120
91 3 6 7 9 17 19 22 24 27 28 29 30 31 38 40 42 43 48 62 65 67 68 70 71 72 81 83 85 95 96 101 103 107 109 110 117
92 1 2 3 4 6 9 12 13 14 15 17 18 22 25 26 27 28 29 30 32 33 35 36 38 39 46 47 48 49 50 51 52 53 54 56 58 59 62 64 65 68 70 71 73 74 75 76 78 82 84 85 86 87 90 93 94 95 98 100 102 103 104 105 108 109 110 111 112 113 114 115 116 117 119
93 2 6 8 9 13 15 17 18 22 26 27 29 30 35 44 47 48 50 51 52 56 57 61 66 69 70 71 75 79 80 81 85 87 88 91 96 99 101 104 107 108 113 114 115 116
94 5 13 58 60 61 63 91
95 3 14 18 19 28 30 36 46 56 59 62 66 72 74 75 80 86 89 91 93 102 104 107 111 118
96 13 22 31 43 51 60 70 77 85 92 107 113
97 1 3 5 8 9 10 12 13 17 19 22 23 24 30 37 38 39 44 45 64 66 70 71 72 74 80 84 85 92 93 94 96 98 102 106 107 112 118 120
98 1 2 3 4 7 9 10 11 12 13 14 15 16 17 18 19 20 21 22 23 24 25 26 28 29 30 31 33 34 36 37 38 39 42 43 45 46 48 50 51 53 54 55 58 59 60 61 65 66 68 72 73 74 75 76 77 78 79 80 81 82 85 86 88 89 90 91 92 93 95 96 97 99 100 101 102 103 104 105 107 108 109 111 112 113 115 116 117 118 119 120
99 4 16 46 51 70 80 86 94 96 108
100 1 2 4 5 6 17 18 21 23 29 32 34 48 57 58 60 61 62 68 73 75 77 83 95 104 112 113
101 1 4 10 17 21 26 29 30 31 34 36 37 43 44 45 46 47 49 50 54 55 58 65 69 70 75 77 78 83 88 89 98 99 105 106 109 111 115 116
102 2 3 5 6 7 8 9 10 11 12 13 14 16 17 18 21 22 23 24 26 28 30 31 32 35 37 38 39 40 41 42 44 45 48 49 51 52 54 56 57 63 64 66 68 69 70 71 72 73 74 77 80 81 82 84 86 87 88 89 90 92 94 95 96 97 98 100 101 105 106 107 108 109 110 111 112 113 114 115 117 119 120
103 16 20 23 45 108 110 119
104 21 40 44 49 89 92 95 96 108 117
105 4 8 10 15 16 18 19 21 23 26 28 33 34 36 38 40 44 48 49 51 52 53 58 59 61 66 67 73 74 75 77 81 82 85 87 88 90 92 93 96 98 99 101 102 104 106 108 109 113 116 117 118 119
106 3 10 11 17 18 24 37 38 43 44 49 58 61 62 63 65 68 72 76 77 79 82 86 89 92 94 95 98 116 120
107 1 4 6 7 9 10 16 18 20 25 26 28 30 36 39 40 55 60 61 63 68 70 72 76 77 87 91 92 95 96 103 108 112 113 116 120
108 4 5 11 17 19 33 35 38 41 45 56 57 67 69 71 74 75 79 81 91 92 94 95 97 101 103 107 113 115 116
109 4 10 13 17 19 30 49 50 51 53 56 76 88 95 105 108 114 116 118
110 10 11 14 17 21 22 24 35 36 46 55 63 74 78 89 105 106 112 114
111 27 34 41 57 95 98 104 109
112 1 2 3 4 5 6 7 8 9 10 11 13 14 15 16 18 19 21 23 24 25 26 28 30 31 32 34 35 39 41 42 44 45 46 47 48 49 50 51 52 53 55 58 59 61 62 63 64 65 66 67 68 69 71 72 73 74 75 76 78 79 80 81 82 84 85 86 88 90 91 92 94 95 96 97 98 100 102 103 104 105 106 107 108 109 110 111 114 116 120
113 2 3 4 6 11 13 15 19 20 23 24 26 27 28 30 31 32 34 35 36 38 40 41 44 45 46 47 48 51 53 56 57 59 60 65 66 68 70 71 73 74 75 77 78 79 80 81 83 93 94 98 101 102 103 105 106 107 110 111 114 116 118 119 120
114 8 13 40 41 57 59 70 74 92 110
115 32 60 84
116 4 9 14 15 16 17 20 21 23 33 42 43 53 54 61 63 69 74 80 90 92 96 100 101 102 109 111 112 113
117 4 36 38 104 105 111
118 9 12 18 24 28 32 38 50 56 57 63 64 65 68 71 76 78 88 89 93 94 101 104 108 113
119 8 9 13 21 22 26 28 51 52 71 86 89 98 104 105 112 115
120 3 7 11 17 19 30 33 36 41 50 52 62 64 67 68 77 78 81 83 84 86 87 91 99 101
