1 22 38
2 1 3 5 6 8 9 10 12 13 15 18 19 20 25 26 27 28 30 31 34 35 36 39 40 41 43 44 47 49 51 52 53 54 55 56 57 58 59 62 63 65 68 70 71 72 73 74 75 76 82 83 86 87 89 90 91 92 93 94 95 97 100 101 102 103 104 105 107 108 110 111 112 113 114 116 118 120 124 125 126 127 129 130 131 132 135 136 137 138 139 141 142 143 144 145 148 149
3 6 18 19 20 27 30 35 40 41 46 49 56 57 60 62 70 78 80 81 82 91 93 99 100 108 111 120 124 125 127 133 136 137 139
4 10 23 42 43 44 63 70 75 79 88 96 126 141 144 148
5 2 4 6 8 10 13 15 17 18 20 21 22 24 26 27 32 33 39 40 41 42 43 48 51 54 55 56 58 59 60 61 63 64 67 69 72 73 74 77 78 79 81 83 84 85 86 88 95 98 100 107 108 109 110 111 113 114 122 123 126 127 132 138 139 140 145 146 150
6 10 19 28 38 54 55 57 62 104 105 112 116 120 131 132 141 142 150
7 1 6 10 12 13 14 15 17 19 23 24 26 28 30 31 32 34 37 39 42 48 49 52 55 56 58 61 64 65 66 67 71 75 76 85 88 89 91 94 96 98 100 102 103 104 105 107 108 111 113 118 119 121 122 125 127 128 129 133 134 135 138 139 142 143 149
8 2 3 5 6 7 9 10 11 12 13 14 15 16 17 18 19 20 21 22 23 25 26 27 28 29 30 32 33 34 36 37 38 39 40 41 42 43 44 45 46 47 48 49 50 51 52 53 54 55 56 57 59 60 61 62 64 65 66 67 68 69 70 71 73 75 76 77 78 79 80 82 83 84 85 86 88 89 91 92 93 94 95 96 97 98 99 100 101 102 103 104 105 106 107 108 109 110 111 112 113 115 116 117 118 119 120 121 122 123 124 125 126 127 128 129 130 131 132 133 134 135 136 137 139 140 141 142 143 144 145 146 147 148 149 150
9 30 98 104 110 150
10 24 91
11 7 8 29 36 39 57 58 61 62 89 107 117 130 136 143
12 3 5 7 8 9 14 15 16 17 18 19 22 23 26 27 29 30 33 36 38 39 41 43 45 46 50 55 56 57 60 63 64 67 70 78 79 83 86 87 89 91 93 95 96 99 102 105 108 111 117 118 119 121 125 126 127 128 129 131 134 135 146 148 149
13 1 2 3 4 5 6 9 10 11 16 18 19 20 21 22 23 24 25 26 27 28 29 32 33 34 36 37 38 39 40 43 44 45 46 47 48 50 51 54 55 56 58 59 62 65 67 69 70 71 72 75 77 78 79 82 84 85 86 87 91 93 95 96 97 100 101 105 106 108 110 111 112 113 116 118 119 120 122 123 124 125 128 129 130 132 133 134 135 137 138 139 141 142 147 148 149
14 30 44 75 89
15 1 2 4 5 8 9 17 18 30 36 39 43 45 47 48 55 58 74 78 82 86 87 88 91 94 98 102 107 108 120 121 138 140 141 145 146 150
16 5 6 8 10 11 13 14 15 17 19 20 21 26 28 31 32 34 36 37 43 44 45 46 52 53 56 57 59 60 62 63 64 65 71 73 75 76 78 79 81 82 83 84 92 93 95 97 99 100 105 107 108 111 117 121 123 124 125 130 132 135 137 141 146 147
17 2 5 12 16 23 27 30 31 33 34 35 39 40 41 46 48 49 51 54 56 57 69 72 73 76 80 83 84 86 87 90 91 94 95 99 102 112 113 116 118 119 120 125 126 136 137 142 143 145 146 147 149
18 4 5 6 7 8 9 10 11 12 14 15 16 17 19 20 21 23 25 27 29 30 32 34 36 37 40 42 45 46 47 49 50 51 52 55 58 60 61 64 66 67 68 69 71 72 76 80 81 84 85 86 87 88 91 93 94 95 97 98 100 102 104 105 106 107 109 110 112 114 116 117 118 120 121 122 123 125 126 127 128 129 132 135 136 137 139 142 143 144 146 147 148 149
19 1 2 9 12 17 22 28 29 31 33 40 41 43 50 53 57 58 61 63 67 69 71 73 74 77 80 90 96 98 99 100 114 116 120 121 122 127 132 135 137 147 149 150
20 60 75 105 115 129
21 2 6 8 9 10 13 15 16 17 19 20 22 28 29 33 36 39 41 43 44 49 51 53 56 67 68 72 77 81 84 86 87 88 89 90 93 95 96 97 99 101 106 107 108 109 114 119 120 121 122 123 125 126 127 128 130 131 137 138 141 147 148 149 150
22 33 43 57 79 93 132 149
23 3 8 12 25 28 33 39 44 45 52 61 63 68 81 94 101 102 106 111 130 132 133 134 135 138 141 148 149 150
24 11 75
25 1 5 7 8 13 14 18 19 21 24 26 30 37 39 44 45 49 51 52 54 57 58 60 62 63 64 65 68 75 76 80 87 91 94 98 99 102 105 108 111 112 114 116 117 120 124 127 131 132 135 136 137 141 145 146 147
26 1 3 5 6 8 9 11 12 13 16 19 21 24 25 27 30 31 32 33 34 35 36 38 40 42 43 47 48 49 50 51 52 55 56 57 58 59 60 65 66 67 68 72 73 76 79 80 81 83 84 85 86 87 89 90 91 92 94 95 96 97 98 99 100 102 104 105 106 107 108 110 111 114 115 116 117 118 123 125 127 128 131 133 134 135 136 140 141 142 143 144 145 146 148 149
27 9 10 16 17 19 30 47 51 64 79 85 94 98 114 121 123 125 126 145
28 8 14 16 17 18 19 24 25 29 30 31 33 35 45 46 49 50 51 59 75 76 80 84 85 92 94 97 100 103 104 109 111 118 120 130 134 139 145
29 7 14 39 50 61 62 64 65 81 87 88 92 114 115 116 128
30 28 31 47 71 82 96 110 140 146
31 3 8 9 10 16 20 21 23 28 30 34 35 44 45 46 48 50 51 52 53 54 56 58 61 62 63 65 66 68 71 73 75 76 77 81 82 83 84 87 88 89 90 91 95 97 101 102 103 107 111 112 113 115 121 124 126 127 128 134 137 138 141 144 145 146 149 150
32 23 55 123
33 4 23 29 34 46 49 72 99 107 132 146
34 3 4 6 8 9 13 15 16 17 18 21 23 24 26 27 28 29 30 32 33 35 36 39 40 42 44 47 49 52 53 55 56 57 58 59 60 62 64 65 68 69 73 74 75 76 77 78 81 82 83 85 90 91 93 97 98 102 105 106 110 111 114 115 116 117 119 121 122 123 125 127 128 132 135 140 143
35 2 4 6 7 8 9 10 11 12 16 17 20 21 22 24 26 28 29 31 34 36 38 39 42 44 50 51 52 57 58 59 60 61 62 63 64 65 66 69 70 71 72 73 75 76 77 78 79 80 82 84 85 86 88 89 90 91 92 93 95 96 101 103 107 110 113 115 116 117 120 123 124 126 128 129 131 132 134 137 140 142 144 145
36 9 13 22 25 33 44 46 50 51 60 69 73 75 86 87 92 93 107 123 128 129 131 136 144 148 150
37 9 12 16 33 34 36 55 59 104 117 120
38 2 9 14 16 18 21 33 35 52 53 57 61 64 66 73 86 89 93 98 103 105 110 114 116 119 122 129 132 136 139 141 143 148 150
39 1 3 4 5 6 9 10 11 12 15 16 17 18 19 20 21 22 23 24 28 29 30 32 33 34 35 36 37 38 42 43 47 49 50 51 54 55 57 58 59 61 63 64 65 68 70 71 72 75 76 77 78 79 80 84 85 87 91 92 93 96 97 99 102 105 107 108 110 111 112 113 114 115 116 117 119 120 121 122 123 125 127 128 129 130 131 132 133 134 135 136 138 139 141 142 143 144 145 146 148 149 150
40 2 4 10 26 43 45 46 48 49 62 77 89 91 92 99 100 105 135 139 140 144 149
41 1 6 8 11 12 15 17 18 26 35 36 37 38 40 43 49 51 54 55 56 61 64 67 73 77 80 85 90 91 95 101 102 106 115 119 125 127 131 133 134 137 140 147 150
42 1 3 9 10 11 12 14 15 17 18 19 20 23 25 30 31 34 35 38 41 43 44 46 47 48 50 52 55 56 57 58 59 61 65 66 67 71 72 73 74 77 78 81 84 86 88 89 90 91 94 96 97 98 99 101 102 105 107 108 109 110 113 115 124 125 127 132 134 139 140 143 148 150
43 1 2 4 5 6 7 13 14 17 18 19 26 31 33 35 36 37 38 41 45 47 48 49 50 56 59 60 62 63 65 69 70 72 77 79 80 81 82 84 85 92 93 94 95 98 99 102 105 109 112 118 119 122 124 131 132 133 134 136 139 140 144 147
44 13 24 26 27 33 45 62 73 81 87 94 102 109 112 115
45 1 3 5 7 10 11 12 13 15 16 18 20 25 27 28 30 32 33 34 37 41 42 44 46 48 49 50 54 55 59 62 66 68 69 71 79 81 82 84 88 93 95 96 99 100 104 105 107 109 110 112 113 114 116 119 120 124 127 128 131 133 135 140 141 143 145 149
46 7 10 19 22 24 27 29 35 40 42 44 47 55 58 62 64 74 75 78 82 85 90 96 107 110 112 121 137 139 141 142 149
47 1 3 5 7 8 9 11 12 14 16 17 21 24 25 27 32 33 36 42 43 44 45 46 49 50 51 52 53 54 56 58 60 61 62 64 65 66 67 68 70 72 73 74 75 76 77 79 80 84 85 86 87 88 92 93 95 96 97 103 105 106 107 108 109 115 117 118 119 121 122 124 125 126 127 128 130 131 132 133 134 135 137 138 140 141 142 143 144
48 1 13 17 22 23 34 35 46 47 50 54 61 62 68 69 77 88 89 90 95 104 105 108 118 130 132 138 143 144 145 147 149
49 2 4 6 7 9 44 53 54 58 63 72 75 78 79 80 88 92 101 105 106 121 130 137 145
50 8 10 15 20 24 35 44 46 52 56 59 66 68 71 80 85 88 93 94 104 106 107 124 125 131 134 138 143 146 148
51 1 3 5 6 7 8 9 10 11 12 13 14 15 16 19 22 23 25 29 31 32 34 36 37 38 39 40 41 42 44 45 46 47 48 49 50 52 54 55 56 58 60 61 62 64 67 72 73 74 75 76 77 78 79 80 81 82 83 84 87 89 90 91 94 95 96 97 99 100 102 103 105 107 110 112 114 115 119 120 121 122 123 125 126 127 128 129 130 131 133 136 139 140 141 142 144 145 146 148 150
52 3 4 5 6 8 9 10 11 13 15 18 20 21 22 23 24 26 30 31 32 33 35 36 37 39 42 46 48 49 53 56 57 60 62 64 66 70 75 76 77 79 80 86 87 88 90 92 94 95 102 103 104 106 111 112 114 115 116 117 118 123 127 128 130 134 136 137 141 142 145 147
53 6 13 15 25 35 47 49 71 94 98 110 112 115 118 120 142 150
54 2 9 15 24 46 56 60 68 78 83 86 89 99 101 106 123 126 128 138 146
55 2 4 6 8 14 15 18 20 21 23 24 25 27 29 30 31 33 34 36 37 38 42 43 44 45 46 47 48 49 52 53 57 59 61 62 63 64 67 71 73 74 75 78 80 81 82 83 84 89 90 91 93 97 100 101 103 104 105 106 109 110 111 112 114 117 120 122 123 130 131 132 133 135 136 138 140 143 145 147 148 150
56 1 5 6 7 10 11 14 17 23 28 32 33 34 36 38 41 48 50 55 57 60 62 65 66 72 76 80 86 90 92 97 98 101 102 108 110 114 120 122 129 131 134 137 142 144 145 148 150
57 1 5 6 12 13 23 24 26 28 29 31 32 35 41 44 46 49 50 51 53 61 62 63 71 74 77 83 86 87 92 95 98 99 101 107 108 110 116 118 119 120 124 126 127 129 131 132 133 134 136 141 148 149
58 82 84 93 106
59 1 2 3 4 5 6 7 8 10 11 12 15 17 19 20 21 24 26 27 28 29 30 33 36 38 39 41 44 45 46 47 48 52 53 54 55 56 57 58 61 62 63 64 66 68 69 70 72 73 76 77 78 81 83 84 85 87 88 89 91 92 93 94 95 96 97 98 99 101 103 104 105 106 107 109 112 114 115 117 119 120 121 123 124 125 126 128 129 130 131 132 135 138 139 140 141 143 144 145 146 147 149 150
60 6 27 41
61 1 2 4 5 6 9 10 11 13 15 16 17 23 24 27 28 30 35 38 40 42 43 46 50 51 52 54 55 56 58 60 63 66 67 68 70 71 72 75 76 77 78 79 81 82 84 85 86 87 88 91 94 95 97 98 100 104 105 106 108 109 110 114 116 123 124 125 126 127 129 130 131 132 133 137 138 139 141 145 147 149 150
62 8 10 15 16 17 18 20 25 27 29 30 34 35 39 41 42 43 46 47 48 49 53 55 56 57 58 59 60 63 68 72 73 75 82 83 84 85 86 89 90 91 92 93 95 96 97 100 103 104 111 113 114 115 116 118 119 121 123 126 127 128 132 133 134 135 137 140 141 144 145 149
63 1 5 7 8 10 13 14 15 18 20 21 23 24 27 29 31 33 35 36 37 38 40 42 43 45 55 56 58 60 66 68 69 70 71 72 73 74 76 77 78 80 82 87 90 92 93 96 97 98 100 101 102 104 108 110 111 119 122 123 126 127 128 129 130 133 135 136 139 140 141 144 146 147 148 149 150
64 9 24 73 130 145
65 9 17 18 41 50 51 52 55 58 62 70 84 88 89 91 94 102 105 110 113 115 122 123 133 137 145 146
66 1 3 6 9 13 14 17 21 23 27 28 29 38 41 45 48 51 53 57 60 61 62 63 64 65 67 68 75 79 80 82 84 87 88 91 96 97 101 102 104 106 111 113 114 116 118 119 120 121 127 133 137 141 142 144 146 148
67 7 11 13 14 22 26 29 33 34 39 43 56 59 64 70 73 83 89 92 95 98 102 104 112 114 120 121 124 125 129 130 135 140 147 148
68 3 11 14 23 39 52 53 59 62 63 65 74 75 77 78 80 92 98 104 109 111 113 119 126 128 129 131 132 138 140 141 146 148
69 15 26 30 88 124 126 138
70 2 3 4 5 6 9 10 11 13 17 18 19 20 21 24 28 32 38 39 43 44 45 47 48 53 54 55 61 67 69 71 74 75 78 84 85 86 89 90 91 92 95 96 97 98 99 101 106 107 111 112 113 116 118 125 126 127 129 132 133 134 137 144 146 147 149
71 4 5 6 8 10 11 12 14 15 16 20 21 22 23 24 25 29 30 33 34 36 37 38 39 40 41 42 47 48 49 50 52 53 54 56 57 60 61 62 63 67 68 70 74 76 78 79 81 83 84 85 87 88 90 91 92 94 95 96 97 99 100 102 104 106 107 109 110 111 112 113 114 116 121 124 125 127 128 129 132 133 135 141 142 144 146 147 149 150
72 3 4 6 7 8 11 12 13 14 16 17 18 20 21 23 28 32 34 35 37 38 39 46 48 49 51 52 54 57 63 65 66 70 73 76 77 79 81 82 83 86 90 92 93 94 99 102 105 108 109 112 114 115 116 117 118 121 123 124 127 129 130 131 132 135 140 141 142 147
73 4 7 8 11 18 19 21 25 32 44 50 52 55 61 68 72 74 76 77 84 89 94 100 101 102 115 117 127 139 142
74 1 2 3 6 7 8 9 12 16 18 19 21 23 25 28 31 32 36 37 38 42 47 48 49 51 52 54 55 57 58 60 62 63 64 65 70 72 73 78 81 82 85 86 87 88 89 90 91 92 93 95 97 98 101 103 107 108 110 113 114 116 117 119 120 123 124 125 126 127 129 131 134 135 138 139 141 142 144 145 146 149
75 2 3 5 7 8 9 10 14 17 18 21 23 24 25 26 28 31 32 33 38 44 52 55 56 58 60 61 63 64 65 66 67 70 71 72 77 82 85 90 93 94 96 101 103 106 108 109 113 115 124 125 126 129 130 131 132 134 135 138 139 141 142 143 148 150
76 3 4 10 11 13 14 19 22 24 28 38 39 40 42 43 48 49 57 58 61 62 64 65 68 69 71 75 80 81 84 86 88 90 91 92 94 97 99 100 101 103 113 116 117 122 134 136 140 141 145 148
77 3 5 14 19 20 26 29 30 32 38 47 48 52 53 57 59 69 73 75 80 82 83 89 90 99 100 101 104 105 108 109 110 118 120 129 134 136 138 140 141 144 146 148 149 150
78 12 15 29 33 71 89 92 94 108 132 141 149
79 1 5 6 7 9 10 11 13 15 16 18 21 24 25 26 29 30 32 33 34 36 39 41 42 43 44 45 46 49 50 53 55 57 58 59 60 61 62 64 66 69 72 75 76 77 80 82 83 84 85 87 88 94 98 99 100 101 105 106 107 108 110 111 112 113 115 119 121 122 123 127 128 129 131 132 133 135 137 140 146 147 148 149 150
80 7 24 50 53 65 76 114 131 147
81 2 5 6 15 19 25 29 37 41 43 44 46 47 54 57 58 63 71 73 83 86 88 91 95 100 105 107 109 111 114 115 116 120 124 126 136 139 148 150
82 1 5 6 7 10 11 12 13 15 17 18 19 22 25 26 27 28 31 32 33 34 35 38 40 43 46 47 48 49 50 57 62 64 66 69 74 75 78 80 83 84 87 88 93 96 97 99 103 109 111 114 115 117 118 120 121 125 128 131 132 133 134 138 142 147 148 150
83 7 15 16 20 27 34 35 38 40 41 43 44 58 66 74 84 87 105 117 120 127 129 130 133 142
84 9 32 40 42 44 46 47 50 52 53 60 70 74 93 96 111 125 136 145
85 36 69 104 137
86 3 4 7 9 21 23 26 27 28 30 34 37 39 41 42 43 44 45 49 50 53 56 60 61 63 65 66 67 68 69 77 82 84 87 92 94 95 99 110 117 119 126 130 133 134 136 140 143 144 147
87 3 6 8 9 11 18 19 25 26 32 37 46 52 54 59 61 64 66 69 71 77 79 80 82 88 89 92 93 97 98 99 100 105 109 124 139 143 147
88 24 61 70 81 113 114
89 2 3 5 6 9 18 24 27 29 30 33 36 37 38 41 53 54 55 62 67 69 100 102 103 109 119 120 121 122 129 130 135 137 139 141 142 147
90 1 2 4 6 12 20 23 29 40 48 60 78 79 85 91 100 108 116 121 129 137 138 140 144
91 11 13 15 26 36 42 47 54 56 68 73 88 97 103 104 109 110 113 115 116 119 123 124 128 129 134
92 8 17 22 29 31 32 36 37 40 52 54 58 71 84 93 94 99 112 115 117 123 126 146
93 4 14 24 25 34 37 38 39 46 51 55 59 73 75 83 90 92 106 109 112 114 117 122 123 126 129 137 139 142
94 1 3 4 6 8 10 13 19 21 23 26 27 28 31 32 33 34 35 38 42 43 44 46 48 49 51 52 55 56 57 65 66 69 71 74 76 77 78 80 81 82 85 86 87 88 90 91 92 93 96 97 99 100 103 105 106 107 111 112 113 114 115 119 121 123 127 132 133 134 137 138 139 141 142 143 145 146 149
95 3 4 7 9 12 13 17 21 22 24 25 31 33 34 36 41 42 45 47 48 49 53 55 57 60 62 63 66 67 68 73 76 77 81 82 86 87 88 90 94 98 102 106 107 108 115 117 119 122 123 125 126 127 128 131 132 134 139 144 145 146 149
96 3 11 38 41 44 55 93 99 110 123 124 141 145
97 8 14 19 25 27 28 29 33 35 37 39 40 41 43 44 45 47 52 54 59 63 64 69 70 75 81 86 90 93 94 95 96 99 100 104 111 112 117 118 119 120 124 127 129 132 133 135 136 138 140 146 149
98 3 6 7 11 13 21 22 26 29 34 35 38 41 43 46 49 57 65 69 71 72 76 79 80 83 84 93 96 99 101 102 106 109 117 118 121 123 128 129 130 131 133 135 146 147 150
99 119 130
100 71 74 91 119 150
101 1 4 5 11 20 28 35 37 38 42 45 46 49 51 53 64 67 68 69 70 71 84 94 99 100 109 110 114 122 123 128 131 132 145 149
102 1 2 3 4 5 7 10 12 17 18 19 20 21 22 24 26 29 32 35 36 37 38 43 44 45 50 51 52 58 63 64 66 68 69 71 73 74 77 79 81 82 84 93 103 104 106 107 110 114 115 116 117 118 119 120 121 122 123 124 127 128 129 130 131 135 139 142 145 146 147 148 150
103 13 38 47 63 66 68 87 94 96 109 118 129 138
104 11 19
105 6 8 11 12 18 22 23 26 38 39 41 53 59 60 70 71 75 76 77 78 83 89 90 93 96 98 99 100 101 107 110 113 121 125 135 139 144 147
106 1 2 3 4 5 6 7 8 9 10 11 12 13 14 16 17 18 19 20 21 22 23 24 25 26 27 29 30 31 32 33 34 35 36 37 38 39 40 41 42 43 44 45 46 47 48 49 50 51 52 55 56 57 58 59 60 61 62 63 66 67 68 69 70 71 72 73 74 75 76 77 78 80 81 83 84 85 86 87 88 89 90 91 92 93 94 95 97 98 99 100 101 102 104 105 107 109 110 111 112 113 114 115 116 117 118 119 120 122 123 125 126 127 128 129 130 131 132 133 135 136 137 138 141 142 143 144 145 146 147 148 149 150
107 59 63 69 77 101 108
108 1 2 5 8 11 12 16 17 18 19 22 23 24 28 32 33 34 36 38 40 43 44 45 51 54 55 56 57 60 62 65 67 68 69 70 72 73 74 76 77 79 82 85 87 91 95 101 102 103 104 106 107 112 114 115 116 119 121 123 124 126 129 130 132 133 136 137 138 139 143 145 146 148 149 150
109 1 9 11 13 16 18 28 30 34 37 42 52 63 67 83 90 115 117 119 121 129 132 136 138 139 140 147
110 5 10 12 13 14 17 19 21 24 28 29 34 35 38 42 44 55 60 63 91 95 98 100 111 113 124 126 141 142 147
111 4 6 11 12 16 17 34 40 41 49 50 52 54 57 65 70 85 89 90 94 97 117 118 122 123 126 131 135 148 149
112 11 17 18 23 25 29 36 40 48 50 53 57 58 59 61 63 73 81 92 94 104 111 118 127 144
113 2 5 6 8 12 18 24 26 35 37 42 47 56 58 62 64 76 82 85 91 93 99 103 108 118 119 120 123 128 138 143 145
114 1 9 11 12 13 15 17 18 20 23 26 29 31 33 37 39 42 44 45 46 47 49 51 52 53 56 60 62 63 64 66 73 74 76 79 80 81 83 84 86 91 95 97 98 99 104 108 111 112 115 118 119 121 125 127 129 131 132 135 137 138 139 140 141 142 146 148 150
115 3 5 11 29 32 45 83 84 110
116 1 4 5 7 9 17 18 19 20 21 24 27 28 32 34 35 41 43 45 46 48 49 52 53 55 56 57 58 64 65 67 68 69 72 74 78 80 82 86 87 88 90 91 92 94 95 96 97 99 101 102 103 105 109 110 112 114 115 117 118 119 122 125 126 127 129 130 131 135 138 141 142 144 145 149
117 19 40 42 64 86 108 125 127 135
118 65 142
119 7 9 18 38 58 81 93 100 131 134
120 1 7 10 52 58 77 78 85 91 122 128 129 136 142 148
121 3 6 9 13 15 18 19 23 24 26 27 28 32 33 35 36 37 38 39 40 42 43 45 46 48 50 51 53 54 55 56 64 73 74 75 76 78 82 84 87 88 90 93 95 99 101 102 103 105 108 117 120 126 127 130 133 134 135 136 137 138 140 141 144 148 149
122 7 82 102 142
123 1 3 4 5 6 9 10 11 13 16 18 19 20 21 23 24 25 27 28 30 31 32 33 34 36 38 41 42 46 47 48 49 52 53 54 55 58 67 68 69 70 71 73 74 75 76 77 79 80 81 87 88 89 93 94 96 97 98 100 101 102 107 108 109 111 112 114 115 117 118 126 128 129 130 132 133 135 139 140 141 143 145 146 147 148 149
124 34 57 79 92 111 122 150
125 2 4 6 17 24 25 35 38 39 43 46 47 50 51 52 53 57 58 59 66 78 86 97 100 112 115 124 128 133 141 148
126 50 63 67 136
127 1 2 12 14 17 18 19 20 22 23 25 29 37 39 40 41 42 43 49 52 53 54 55 56 58 60 62 64 66 72 73 76 77 78 80 82 83 84 85 87 89 90 91 92 100 106 108 109 110 111 120 122 125 126 129 132 133 134 137 140 145 149 150
128 2 25 26 40 51 104 121 127
129 1 2 3 5 6 7 9 10 11 12 15 17 18 19 20 22 23 24 25 27 28 29 30 33 34 35 36 37 38 42 43 44 45 46 48 49 50 52 53 55 56 57 58 59 60 61 63 64 65 68 71 72 73 74 75 77 78 79 80 83 84 85 86 87 88 89 90 93 96 97 98 99 100 101 102 103 104 105 106 107 108 111 112 113 115 117 119 120 121 122 125 126 127 128 130 132 133 134 137 138 139 141 142 143 144 146 147 148 149 150
130 10 14 27 29 42 71 73 86 88 91 97 102 121 126 128 137 140 150
131 4 7 8 10 15 16 18 30 31 35 39 40 75 78 83 87 92 93 95 98 102 105 107 111 113 116 121 122 132 145 146
132 1 2 4 6 7 8 9 10 11 16 17 19 21 22 23 26 28 30 31 33 34 35 37 38 39 41 43 45 47 48 50 52 57 58 59 60 61 62 63 65 66 67 69 70 71 72 74 75 76 77 78 79 80 81 82 87 88 89 90 92 93 95 97 98 99 100 101 103 104 105 106 107 109 110 111 112 113 114 115 117 118 120 121 122 123 124 126 128 129 130 133 134 135 136 137 140 141 142 145 146 147 148 149 150
133 3 4 7 8 16 20 21 22 24 25 29 33 34 37 39 42 43 44 46 47 49 51 53 58 61 64 65 68 71 72 74 77 78 79 80 82 87 88 94 99 101 104 107 109 116 120 121 122 124 125 127 130 132 134 135 141 142 150
134 40 71 72
135 6 10 12 14 20 23 25 32 34 36 38 42 47 55 56 57 59 61 62 71 74 75 77 81 86 100 101 106 111 114 115 116 117 118 121 127 128 132 134 136 137 140 141 146 147 148 149
136 11 12 18 27 29 33 43 44 47 49 52 69 72 83 87 98 100 105 109
137 1 2 3 4 8 12 13 14 15 16 19 20 21 23 24 25 26 27 28 30 31 32 34 38 39 41 42 44 46 48 49 51 52 53 54 55 59 62 63 64 66 69 70 71 72 76 78 81 84 86 88 90 93 94 96 97 98 99 101 102 103 104 105 106 107 113 117 119 122 124 126 127 129 131 133 134 136 140 141 144 146 147 148 149
138 9 16 29 32 38 41 60 65 66 72 77 86 87 103 104 108 111 114 118 119 120 127 129 131 132 142
139 1 3 11 12 19 21 31 42 53 56 62 67 68 69 76 83 84 86 90 99 111 117 129 134
140 9 65 75 98 99 101 132 135 146
141 8 17 32 34 35 46 55 80 86 110 112 132 135 144
142 1 54 116 120 124 126 136
143 5 8 9 10 11 12 18 19 22 23 24 26 28 29 31 32 39 41 49 50 54 57 60 74 76 77 83 91 93 95 98 99 105 111 120 123 127 130 133 135 140 141 144 150
144 24 26 34 50 80 87 88 105 135
145 13 70 106
146 5 6 9 13 23 30 32 33 38 39 44 50 64 70 76 79 80 84 101 112 116 125 127 131 144 148
147 5 6 11 12 15 16 18 20 25 32 34 35 38 40 45 50 51 53 61 65 72 78 81 82 83 84 91 97 98 99 100 101 104 105 106 108 110 111 112 114 116 119 120 121 122 123 138 144 150
148 2 3 4 5 10 12 13 14 16 17 18 19 20 21 23 24 25 27 28 30 31 33 34 36 37 39 41 44 45 46 47 50 53 55 57 59 60 62 64 65 66 67 69 70 71 72 74 75 76 77 78 79 82 83 84 85 86 92 94 95 98 99 100 102 103 104 106 107 109 111 114 115 116 117 118 120 121 122 123 125 127 128 130 131 132 133 137 138 140 141 142 143 144 146 147
149 8 9 15 19 23 29 38 66 68 78 92 97 125 129
150 2 3 4 5 7 9 19 26 37 39 41 42 43 46 54 55 57 68 70 75 83 84 87 90 93 97 100 101 103 109 114 116 117 121 128 135 140 142
