1 3 5 13 19
2 6 9 10 12 16
3 4 5 6 8 10 11 12 13 14 17 20
4 1 2 6 9 11 12 13 15 16 20
5 1 3 4 6 8 9 12 13 16 18 19 20
6 3 8 11 15 16 19 20
7 11 16
8 2 3 4 5 9 17 20
9 1 2 7 10 12 16 20
10 1 3 4 5 6 8 9 11 12 16 17 18 19 20
11 3 16
12 1 2 13
13 6 11 19
14 11 17 19
15 1 2 5 7 11 13
16 1 2 5 6 9 12 17 19 20
17 2 3 4 5 8 9 10 12 13 16 18 19 20
18 15 20
19 1 4 5 6 7 8 9 11 12 14 16 17 20
20 1 2 3 4 8 9 12 17 18 19
