1 12 28 44
2 3 4 5 6 7 8 10 11 12 13 14 15 19 20 21 23 24 25 26 27 28 29 30 32 34 35 36 37 38 39 41 42 43 45 46 47 48 49
3 2 10 27 33 35 39
4 2 9 10 24 34 36 37 39 40 47
5 4 14 17 32 36 38 42
6 2 3 11 14 15 18 27 46
7 2 5 8 9 15 17 20 21 24 28 29 33 34 38 41 44 45 50
8 1 3 13 15 17 30 33 38 44 45 48 50
9 2 22 24 26
10 5 20 23 30 31 37 38 39 50
11 10 15 50
12 4 10 11 20 23 25 26 32 36 39 47
13 20 35 37 41
14 3 4 5 8 10 11 12 18 27 30 31 32 34 36 37 39 43 44 46 47 48 50
15 8 13 14 18 23 28 40 45
16 15 22
17 1 2 8 9 11 12 13 16 18 19 22 25 29 30 32 35 47 50
18 2 4 11 14 15 17 21 24 32 33 35 40 43 45 48
19 2 3 5 6 7 13 16 17 18 23 24 30 33 34 37 44 47 48 49
20 11 21 34 48
21 1 3 10 11 12 14 15 16 17 20 24 28 29 32 33 34 37 43 44 46 47 48 49
22 4 9 16 20 23 27 47 48 49
23 19 21 27 28 37 39 42 43 44 47
24 5 6 8 9 10 19 22 23 26 27 29 31 32 33 35 36 37 38 43 44 46 47
25 2 9 28 29 31 37 38
26 2 3 5 9 10 11 13 14 16 18 20 21 23 24 28 29 30 31 32 33 35 39 40 42 43 44 46 47 50
27 1 2 4 5 6 7 8 9 10 11 12 13 14 16 17 18 19 20 22 24 25 26 28 29 30 31 32 33 34 35 37 39 40 41 42 43 44 45 47 48 49 50
28 1 5 6 7 10 11 12 18 20 23 31 37 38 48
29 11 14 37
30 3 10 11 22 32 47
31 21 38
32 1 3 4 5 6 7 9 10 14 15 17 19 20 21 22 24 26 27 28 29 30 31 33 34 35 36 39 40 41 42 43 46 47 48 49
33 20 34
34 10 12 24 25 26 28 29 36 46 47 49
35 42 47
36 5 13 15 16 22 26 42 43 44 49 50
37 1 2 3 4 5 7 8 11 12 13 15 16 17 18 19 20 21 22 23 24 25 26 28 29 30 32 33 34 40 41 42 43 44 45 47 49 50
38 1 2 6 7 8 9 11 12 14 15 18 19 20 22 23 24 25 27 28 29 31 32 35 36 37 40 42 44 45 46 50
39 1 7 28 46
40 1 2 3 4 5 6 7 8 12 14 16 17 20 22 23 27 29 31 32 37 38 42 44 45 46 49
41 2 3 4 5 6 7 10 11 13 14 15 16 23 24 27 28 29 30 31 32 33 34 35 38 39 42 48 50
42 4 5 7 9 10 12 14 15 17 20 24 26 27 28 30 31 34 38 44 46 50
43 1 11 12 14 15 18 21 22 28 33 34 35 38 41 42 48
44 10 11 34 35 38 40 41 43 50
45 3 24 27 36 38 40 46
46 2 3 5 6 7 8 10 11 12 13 14 15 16 17 18 20 22 23 24 25 27 28 29 30 32 34 36 37 38 39 40 41 42 44 45 48 49 50
47 1 2 5 6 7 8 9 10 11 15 16 17 18 20 21 27 29 30 31 32 34 35 37 38 39 40 42 43 44 45 46 49 50
48 6 39 41 44
49 1 2 5 7 9 10 11 12 13 17 18 19 21 24 25 26 27 28 29 32 34 35 36 37 41 42 43 44 45 47 50
50 4 5 9 11 22 27 31 39 43 45 49
