1 14 26 52 56
2 12 13 17 26 28 32 33 34 39
3 4 6 9 11 23 35 37 38 39 44 46 51 52 54
4 2 3 5 7 10 11 13 15 17 24 30 31 32 33 34 35 38 40 42 43 44 48 50 54 55 56 57 60
5 3 4 19 30 31 37 39 41 56 58
6 1 7 8 12 14 15 21 22 31 36 44 47 48 49 51 54 55
7 2 3 14 21 32 37 53
8 4 7 11 13 22 23 37 51
9 1 19 28 37 41 47 49 51 59
10 42 45
11 1 16 24 25 32 35 41 49 51 53
12 1 2 3 6 7 9 11 13 14 15 16 17 19 20 21 24 27 28 29 30 32 35 38 39 40 41 42 44 45 47 48 53 54 55 57 58 59 60
13 1 2 4 5 8 17 19 20 22 23 24 27 28 30 31 32 33 35 36 38 40 42 44 45 47 50 51 58 60
14 13 26
15 4 17 24 26 54 58
16 1 8 10 12 13 14 25 26 27 29 31 32 37 42 44 49 50 54 57 60
17 7 8 12 19 27 33 34 41 46 47 49 54
18 4 6 8 10 12 16 20 22 29 32 34 35 36 43 44 51 56 57 59
19 2 3 5 7 9 11 12 13 16 17 21 22 24 26 27 28 29 30 33 39 40 42 45 47 48 49 50 51 52 53 54 56 57 59 60
20 8 10 11 16 19 30 36 40 46 47 50 51 58
21 1 2 4 7 9 11 13 18 19 23 25 41 44 45 47 51 52 54 55 56 57 60
22 3 4 9 10 12 14 15 27 30 36 37 41 42 43 45 55 60
23 1 4 7 11 13 15 16 19 20 21 26 32 33 34 35 40 41 44 46 50 51 52 53 55 57 58
24 20 29 38 40 41 45 47 50 51 52 57
25 6 7 9 10 14 17 19 20 32 33 36 38 44 48 51 54
26 27 32
27 5 10 12 20 22 26 28 29 32 33 36 39 40 43 45 46 47 50 51 52 54 59 60
28 2 3 4 5 6 7 9 10 11 12 15 16 17 18 19 20 21 23 24 25 26 27 29 30 33 34 35 37 38 39 40 41 43 45 46 47 48 49 50 51 52 53 54 55 56 57 58 59 60
29 1 27 60
30 3 7 14 33 37 43 44 45 50 52
31 13 20 39 55
32 1 5 9 12 19 23 24 29 40 42 57
33 1 5 6 7 25 28 29 31 32 35 40 47 53
34 2 5 8 17 30 37 38 42
35 3 12 13 19 20 21 23 28 29 30 31 38 44 52 57
36 10 27
37 12 39
38 27 36 39 44 46 54 58
39 1 3 4 5 6 8 9 10 12 14 15 16 17 22 24 25 28 29 30 31 33 34 36 37 38 41 42 43 45 47 48 49 50 53 54 55 57 58 59
40 13 36 39 49
41 1 4 5 6 7 8 9 10 11 13 17 18 19 24 26 28 30 31 34 35 36 39 42 43 44 45 48 49 51 52 56 57 58 60
42 1 7 13 21 23 26 29 30 38 45 46 47 48 52 54 56 58
43 1 2 5 6 8 9 10 12 13 15 16 17 19 20 21 22 26 27 30 32 35 37 41 44 46 47 48 49 51 53 54 55 58 59 60
44 3 57
45 6 9 10 19 33 38 48 51 54 56 60
46 8 13 26
47 8 9 12 14 19 22 24 30 37 43 46
48 3 9
49 3 5 6 8 10 12 16 20 21 22 23 25 26 28 29 31 32 36 38 42 43 46 48 54 55 56 57 58
50 5 8 17 34 35 41 45 49 56 60
51 18 29 44
52 1 3 4 5 6 8 10 12 13 14 16 18 19 20 21 25 26 27 29 30 31 32 33 35 39 40 41 42 46 47 48 49 51 53 54 56 59
53 5 7 19 27
54 2 4 5 7 8 9 10 12 14 17 20 22 25 26 28 29 30 31 33 34 37 41 42 43 46 48 49 50 51 52 53 59 60
55 3 5 9 12 14 17 19 22 24 25 29 32 33 34 36 37 40 43 45 46 49 50 52 53 54 60
56 2 3 7 9 16 18 19 20 21 22 23 24 26 28 29 33 35 36 37 39 43 49 50 53 55 58
57 2 6 11 12 14 17 18 20 25 37 39 45 47 55
58 4 5 8 9 12 14 17 18 24 25 27 28 32 33 36 39 41 43 44 46 47 49 53 55 56
59 2 7 11 13 22 23 24 31 32 33 40 41 49 51 52 54 55 57
60 32 45
