1 4 12 19 29 35 42 47 50 51 57 61 66 75 80 84 86 87 100
2 4 6 9 11 14 17 20 25 27 31 33 35 36 37 50 57 58 60 65 66 67 68 73 77 80 86 89 90 91 93 97 98 99 100
3 44 54 78 79 86
4 15 46 88 89 94 96
5 7 9 12 14 21 28 39 40 47 48 49 59 70 73 80 88 89
6 8 26 34 50 57 71 72 76 83 84
7 2 4 6 9 10 11 12 28 29 30 31 35 36 38 39 46 51 53 59 61 65 68 70 75 91 93 96
8 7 9 15 17 22 31 37 42 46 50 56 66 68 77 87 89 92
9 12 20 28 29 34 38 39 48 52 59 61 68 84 93 94 98
10 2 3 4 5 6 7 8 9 11 12 13 14 15 16 17 18 19 20 21 22 24 25 26 27 28 29 32 33 34 35 36 37 38 40 41 42 43 44 45 46 47 48 49 50 51 52 53 54 55 56 58 59 60 61 62 63 64 65 66 68 69 70 71 72 73 75 76 78 79 80 81 82 83 84 85 86 87 88 89 90 91 93 94 96 98 100
11 1 4 6 7 8 9 13 15 16 17 22 23 25 32 33 34 39 42 43 47 50 53 54 55 58 60 62 67 70 73 74 78 80 82 84 88 91 97 98
12 6 79
13 1 9 14 18 19 26 28 35 36 39 52 59 71 77 89 91 92 93 98
14 7 12 16 19 24 25 40 48 50 61 68 72 78 80 100
15 1 3 5 9 12 13 14 24 29 33 34 41 44 47 49 50 51 52 56 64 65 66 68 71 73 74 76 79 80 82 86 88 89 90 91 92 94
16 19 52 70
17 2 5 6 8 11 12 14 15 16 18 19 22 26 28 29 30 32 33 34 40 42 43 45 47 49 51 55 61 62 64 69 72 79 81 85 86 87 89 94 100
18 2 4 5 6 7 8 9 10 11 14 15 16 17 19 20 22 27 28 29 30 31 35 36 37 41 42 43 44 45 46 47 48 49 50 51 52 54 56 57 58 59 61 63 67 68 70 71 72 73 74 75 76 77 78 79 81 82 83 85 86 88 89 90 91 94 96 97 99 100
19 3 5 8 10 12 16 18 26 30 33 36 42 45 46 47 48 52 62 64 65 70 72 75 77 78 83 84 89 95 97
20 2 6 8 13 25 28 33 35 37 45 49 55 56 58 59 64 66 67 71 75 78 80 86 96 97 100
21 12 20 24 26 35 36 38 47 56 58 59 65 69 79 80 85 89
22 1 2 3 4 5 6 7 8 9 10 11 12 13 14 15 16 18 19 20 21 23 24 25 26 27 29 30 31 32 33 35 38 39 40 41 42 45 46 47 48 49 50 51 52 53 55 56 57 58 59 60 61 62 64 65 66 67 69 70 71 72 73 74 75 76 77 78 79 80 81 82 83 84 85 86 87 88 89 90 91 92 93 94 95 96 97 98 100
23 2 12 18 20 24 25 28 29 30 31 35 37 41 43 46 47 51 52 56 58 59 64 66 69 71 72 74 76 78 79 81 82 83 86 87 93 95 96 98
24 6 8 9 32 45 47 49 56 57 62 66 69 80 83 90 100
25 2 6 11 12 18 21 23 28 31 44 55 56 62 67 68 70 74 75 78 81 85 86 89 90 91 93 99
26 6 23 28 29 34 40 48 63 81
27 5 7 29 41 60 83 97
28 4 6 15 35 41 43 55 66 67 70 74 80 97
29 19 41 44
30 2 7 11 16 17 18 20 29 31 42 43 47 49 50 51 53 54 56 58 61 69 73 74 80 81 82 88 89 94
31 2 3 4 8 16 18 21 22 26 28 35 37 39 41 43 46 47 48 51 54 59 63 64 65 72 76 78 79 81 82 83 85 91 93 96 98 99
32 86 91
33 14 27 43 51 59 67 87 88 96
34 1 3 4 5 6 7 8 9 10 11 12 13 15 16 23 26 30 33 39 41 42 43 44 45 49 50 51 52 53 55 58 59 65 66 67 69 70 71 72 73 74 75 78 86 87 88 90 91 92 93 96 97 98 99 100
35 1 4 10 13 18 19 20 22 23 25 26 28 31 32 34 37 38 39 42 43 45 46 47 49 50 51 54 56 57 59 61 62 67 69 70 72 73 75 77 79 80 82 84 88 89 92 97 98 99
36 1 11 18 21 29 32 33 34 38 49 52 55 62 64 95 98
37 2 5 6 8 11 12 15 18 19 21 24 25 26 27 28 29 30 35 38 45 46 47 48 50 53 54 59 61 63 65 67 68 69 73 74 76 77 79 80 81 83 89 90 92 96 98 99
38 2 6 7 17 37 48 56 89 98 100
39 3 21 43 44 49 57 61 63 75 76 89
40 8 18 24 27 29 41 59 63 66 75 82 87 93 96 100
41 2 51 59 92 100
42 1 3 4 5 6 9 10 11 12 14 16 17 18 20 21 25 30 31 33 35 36 39 43 47 48 49 50 52 53 54 55 56 57 58 59 60 61 62 63 65 66 67 68 70 72 73 74 75 80 82 84 85 86 88 89 90 91 92 95 96 97 100
43 7 16 17 21 22 25 26 36 39 51 58 61 63 65 68 73 76 79 96 100
44 31 45 69 76 88 100
45 6 9 11 12 13 14 15 16 18 19 23 28 29 30 31 33 34 35 36 37 38 39 42 46 47 48 51 52 53 54 58 59 61 62 65 66 73 74 78 80 82 83 91 92 93 94 95 96 97
46 1 80 87
47 1 30 36 40 51 62 77 87 89 93
48 1 2 3 8 9 11 14 16 24 25 26 27 28 29 32 35 37 41 42 45 49 52 58 60 63 68 70 72 73 78 79 81 83 85 87 90 98 100
49 16 17 27 28 38 41 45 59 76 82 87 89 97 98
50 11 30 31 61 64 88 89 90 92 95 96
51 1 2 3 5 11 13 14 18 21 22 23 24 25 26 27 28 29 31 35 39 40 41 42 43 45 46 47 48 49 52 53 54 55 56 57 59 66 68 70 71 72 73 76 77 78 80 82 83 84 86 89 93 94 97 98 99 100
52 5 6 7 10 12 13 17 23 24 25 27 33 34 36 37 41 43 44 45 46 47 50 51 54 58 60 62 65 69 70 76 79 82 84 85 87 88 89 92 97 98 99
53 7 26 28 38 42 49 60 68 92 96 97
54 14 20 23 29 37 41 56 80 100
55 32 56 57 70 72 90 92
56 25 30 33 100
57 10 13 17 20 22 23 26 27 32 33 34 38 41 44 46 50 53 54 55 64 78 92 98
58 2 6 10 12 14 15 22 24 26 27 30 31 33 36 37 39 44 48 49 56 57 63 64 65 66 70 72 74 75 76 79 81 84 85 89 95
59 5 8 14 19 20 43 46 85 86 94 95
60 8 10 21 23 27 28 29 38 46 47 51 62 64 66 71 72 76 77 85 92 95 96
61 1 2 18 22 27 30 44 59 75 77 80 85 90 91 94 100
62 12 16 17 19 22 26 33 38 41 46 49 50 59 64 99
63 1 3 4 6 12 16 17 18 20 21 22 23 24 25 26 27 29 34 36 39 40 43 45 48 50 52 53 54 55 61 62 68 69 73 80 84 86 87 88 91 97 99
64 21 46 54 68 99
65 4 5 8 31 36 55 58 60 63 66 78 79 88 100
66 1 5 6 7 13 15 19 20 23 26 29 33 36 41 43 44 46 52 53 55 59 60 64 68 76 77 82 84 86 88 90 99
67 75 86 96
68 8 15 16 20 22 26 28 34 35 38 44 48 54 58 59 60 65 66 67 73 74 85 90 95
69 5 8 9 10 17 32 34 50 63 87 90 92 94 99
70 17 18 23 32 37 43 49 60 67 80 96
71 9 17 43 100
72 11 17 22 24 42 63 66 71 79 90 100
73 2 3 4 5 7 8 9 10 13 14 15 16 17 18 19 20 21 22 23 26 27 31 32 36 37 39 40 41 42 43 45 46 47 48 49 51 52 53 58 59 60 67 68 70 71 72 74 79 81 82 83 84 85 86 88 89 90 92 94 95 97 98 99 100
74 13 24 26 27 29 34 40 42 51 52 69 71 82 84 87 89 94 100
75 1 2 5 6 7 8 9 11 12 13 14 15 18 19 20 21 22 24 25 27 28 29 30 31 32 33 34 35 36 37 38 40 41 44 45 46 47 48 50 51 54 55 56 57 58 59 60 62 64 66 68 70 72 73 74 76 77 78 79 80 81 82 83 84 85 86 87 88 90 91 93 97 98 99 100
76 4 11 13 19 43 50 60 66 67 68 94 97
77 1 2 3 4 5 7 9 10 14 15 16 17 18 20 21 24 25 28 29 32 34 35 36 38 39 40 41 42 45 46 47 48 49 50 53 54 57 59 60 61 63 64 65 66 67 69 71 73 75 76 80 81 82 83 86 87 88 89 90 91 94 97 98 99
78 6 7 8 10 12 13 14 15 16 20 22 23 24 26 27 29 30 31 32 33 34 36 37 38 39 41 43 44 47 48 50 52 53 55 56 58 59 60 61 62 63 64 65 66 67 68 69 72 73 74 75 76 77 80 85 87 88 89 90 92 93 97 99 100
79 1 2 4 6 7 8 9 10 13 16 17 19 20 21 23 24 25 28 29 31 32 33 35 36 39 41 44 46 50 51 52 54 55 56 57 58 60 61 62 63 64 67 68 71 74 75 77 78 82 83 85 86 89 92 95 98 99
80 10 12 40 43 44 52 60 61 70 71 82 97 98
81 23 68
82 1 3 6 12 15 19 23 24 25 29 39 44 45 47 77 81 98
83 1 13 26 31 34 36 46 50 57 61 79 80 81
84 45 53 60
85 1 8 10 13 14 21 23 24 25 26 28 29 30 31 33 37 41 42 52 53 55 67 70 71 77 78 82 83 87 88 91 92 93 96 98
86 1 16 17 21 22 33 37 40 49 61 87
87 4 5 15 29 31 33 42 44 45 65 70 73 79 81 82 86
88 19 22 24 27 34 41 54 58 64 79 84 86 95 98
89 3 55 76 83 84 87 93 99
90 2 6 8 15 27 31 33 36 39 40 43 47 49 71 74 93 94 96
91 5 10 12 13 14 17 21 24 30 31 33 38 40 42 43 52 58 59 60 63 66 67 74 82 85 88 89 90 94 97 99 100
92 19 55 73 75
93 3 8 20 22 29 31 36 69 73 77 95
94 21 40 42
95 1 2 3 5 8 14 16 19 26 27 28 29 32 35 37 38 40 42 43 44 46 50 53 55 58 60 62 65 66 67 68 69 70 73 74 75 76 77 78 79 82 83 90 92 97 98 100
96 1 2 3 4 5 9 10 11 12 13 15 16 17 19 20 22 23 24 25 26 27 28 30 31 32 33 34 35 36 37 38 39 40 41 42 43 44 45 46 47 48 49 50 52 53 54 55 56 57 58 60 62 63 64 65 66 68 69 70 71 73 74 75 76 77 78 79 81 82 84 85 87 89 91 92 93 94 95 97 98 99 100
97 1 2 9 15 25 69
98 8 9 23 41 46 74 87
99 2 5 6 12 17 25 37 48 49 54 59 60 61 68 69 70 72 96 97
100 17 69
