1 6 20 23 25 27 28 34 35 48 51 54 55 59 60 73 74 75 76 79 86 90 96 97 100 103 121 123
2 7 8 9 15 19 20 26 27 28 35 36 40 41 42 49 50 51 54 55 56 57 58 59 64 65 70 75 78 79 80 83 85 86 98 101 105 106 108 112 113 114 116 117 121 122 123
3 4 9 12 15 18 20 21 22 28 34 35 39 40 46 47 50 52 53 57 58 59 65 69 74 78 79 83 93 104 105 106 115 117 120 122
4 2 14 37 41 44 64 71 73 95 99 121
5 1 2 7 9 17 26 32 34 36 39 43 45 48 55 61 65 68 74 78 94 101 103 109 110 111 122 124
6 11 14 27 35 38 40 41 43 45 50 59 62 70 78 81 84 89 92 93 95 102 103 106 108 117 119
7 2 3 6 15 19 21 22 27 28 29 31 33 34 43 46 47 48 57 60 61 62 63 65 66 67 69 73 76 80 82 86 95 106 108 111 116
8 12 20 21 23 25 27 31 32 40 50 51 54 55 56 63 68 79 80 88 108 109 113 115 119
9 21 80 96 110 125
10 1 2 3 4 5 6 7 8 9 12 14 15 16 17 18 19 20 21 22 24 26 29 30 32 34 35 36 37 38 39 40 43 45 46 47 48 49 50 51 52 56 57 58 59 60 61 63 67 68 70 72 75 76 80 81 85 86 87 88 89 90 91 92 93 94 95 97 98 99 103 104 106 108 111 112 113 114 115 116 117 119 120 121 123 124 125
11 3 5 8 12 13 14 15 17 18 19 21 22 23 24 26 27 29 30 31 33 34 35 38 40 41 43 44 45 46 47 48 49 51 53 54 56 60 61 67 69 76 78 79 80 81 83 84 86 90 93 94 96 97 98 99 101 107 114 115 124 125
12 1 2 3 5 6 8 9 11 13 14 15 16 18 19 20 21 22 23 24 25 26 27 28 29 30 32 33 36 37 39 40 41 44 45 46 48 50 52 54 55 56 60 65 67 70 71 72 73 74 76 78 79 80 81 82 83 85 86 87 88 90 91 92 93 94 98 99 100 101 104 105 106 108 109 110 112 113 115 117 118 119 120 122 123 125
13 4 8 14 16 17 18 32 37 39 40 48 54 62 67 75 78 80 81 82 89 91 92 93 94 95 96 99 100 101 102 104 106 108 112 113 119 120 123
14 2 3 7 15 36 82 88 115 122
15 1 4 7 8 10 14 16 20 21 25 30 32 33 38 41 42 43 47 49 50 56 58 59 67 68 72 74 75 76 77 78 82 85 88 92 94 96 99 101 102 108 110 111 112 113 114 115 118 119 122
16 3 6 9 12 19 20 21 24 35 37 47 48 49 50 53 60 62 70 72 76 86 88 95 96 100 102 106 114 115
17 2 8 9 10 12 18 20 22 23 24 25 34 36 37 38 39 40 42 43 44 48 49 51 53 57 59 61 63 69 70 71 76 78 81 82 83 84 88 89 92 97 100 108 113 116 124
18 9 10 11 12 16 32 55 58 59 63 77 83 94 102 107 110 118
19 2 9 16 52 63 66 67 71 72 82 83 84 85 88 89 117 123 124
20 4 36 50 123
21 30 82
22 1 3 8 15 16 20 21 23 25 26 27 29 32 34 35 36 37 38 41 44 47 48 49 51 52 55 56 58 62 63 65 67 68 72 73 74 75 77 80 86 98 102 105 111 112 113 114 117 118
23 4 6 21 25 29 32 35 36 44 47 50 51 54 58 65 75 87 92 98 102 107 111 112 114 124
24 8 10 11 14 17 20 21 30 37 48 51 60 65 71 75 76 77 78 80 84 88 89 94 99 100 104 111
25 2 4 5 8 9 12 13 14 16 17 19 20 22 24 26 27 29 31 32 33 35 37 39 41 42 44 46 47 48 49 50 51 52 53 56 57 58 59 60 62 64 66 67 69 70 72 73 74 77 78 80 81 82 83 84 85 88 90 92 93 94 96 97 98 99 100 101 105 106 107 108 109 112 113 115 116 118 119 120 123 124 125
26 6 7 11 13 22 29 31 34 43 44 45 49 50 55 58 61 72 75 76 83 88 93 96 99 102 104 109 113 114 119 122
27 3 5 7 8 9 12 14 18 24 28 29 33 37 38 39 40 41 43 45 46 48 49 53 55 58 60 61 63 64 67 68 69 71 73 76 77 81 82 83 84 85 87 90 91 95 97 98 99 103 104 109 110 111 113 114 115 116 117 119 123 125
28 1 2 5 6 12 13 15 16 19 21 22 25 26 31 33 35 37 39 40 43 47 48 49 50 52 54 55 56 58 63 66 67 68 69 72 74 77 79 80 81 82 89 90 91 92 93 95 103 104 105 108 109 115 117 120 121 122 123 125
29 1 4 54 56
30 11 27 43 76
31 33 35 41 47 91 108 116 120
32 1 2 5 6 7 9 10 12 13 14 16 18 19 20 21 22 23 24 25 26 27 29 30 31 33 35 36 39 40 41 42 46 47 49 51 52 56 61 62 63 64 73 76 79 80 81 84 86 88 90 91 93 94 95 97 98 99 101 104 105 107 110 112 114 116 117 122 124
33 1 2 5 7 10 13 14 15 16 17 18 24 25 30 31 32 35 36 37 40 41 43 48 51 56 58 59 63 64 66 68 71 75 80 81 82 84 86 87 89 91 92 93 94 95 97 98 99 102 104 105 106 107 108 109 110 111 112 114 115 119 120 122 123
34 14 22 24 29 31 36 38 41 42 50 54 74 88 89 95 108 118 123
35 6 7 9 22 23 24 25 44 47 58 69 73 76 77 80 84 87 91 92 111 115 116 119 122 125
36 22 55 58 80 90 92 97 105 114 117 118 124
37 1 3 10 13 20 34 44 52 58 62 82 84 92 97 106 108 109 111 122 125
38 30 42 52 93
39 6 7 8 10 11 12 16 18 20 22 29 31 32 36 40 43 46 49 55 56 59 60 62 63 64 65 67 68 69 70 77 79 80 83 85 88 89 93 94 99 101 103 104 105 106 112 119 122 123 124 125
40 1 2 3 4 7 11 12 13 14 15 16 17 20 21 22 23 26 27 28 30 31 32 33 34 36 37 38 39 43 44 46 47 50 52 53 54 56 57 60 61 63 64 65 66 67 69 70 71 72 74 76 77 78 79 80 81 84 85 87 88 89 90 91 92 94 97 98 99 100 101 102 103 104 107 108 109 110 112 113 115 116 117 118 119 120 121 122 123 125
41 4 6 7 11 15 18 20 22 23 24 25 29 31 37 47 48 49 51 52 53 54 56 59 60 64 68 69 74 75 76 80 82 87 92 95 100 101 104 105 106 107 108 110 111 115 117 118 123
42 16 48 75
43 16 39 42 88 92 121
44 9 12 18 39 54 56 73 75 78 89 100 102 106 111 118 120
45 29 43 102
46 2 6 12 13 14 19 21 25 28 31 37 43 44 51 53 54 56 66 70 72 74 75 77 81 86 89 92 95 96 97 99 106 112 114 116 117 121 123
47 15 19 24 25 49 58 71 74 78 84 91 105
48 2 4 9 15 18 22 25 27 29 36 47 52 53 57 61 62 65 67 68 74 76 79 81 85 89 92 95 96 99 106 114 120 121 122
49 4 7 8 9 10 12 14 15 16 18 24 25 28 29 31 32 34 35 36 37 39 40 41 42 43 44 50 51 52 56 57 58 59 60 61 62 63 64 67 69 72 73 74 76 77 80 81 83 84 85 87 90 93 94 103 104 105 108 109 110 112 116 118 120 123 124 125
50 53 97 100 103 104 106
51 1 2 4 6 7 13 18 24 31 32 37 44 46 57 61 67 75 77 79 85 86 88 89 101 103 104 106 109 112 113 115 119 122
52 10 20 28 48 107
53 6 7 24 31 32 34 39 48 56 65 68 72 79 85 89 92 94 95 99 112 115
54 3 6 9 11 12 36 38 40 48 55 62 78 84 86 88 91 109 115 117 119 122 123
55 1 2 3 4 5 7 12 13 14 16 17 18 19 22 23 25 26 27 29 30 31 35 36 38 39 40 41 42 43 45 46 48 49 51 53 54 56 57 58 60 61 62 64 66 69 70 71 72 74 75 76 78 80 81 84 86 87 88 89 90 92 95 96 97 99 101 102 104 105 106 109 110 111 112 113 115 121 122 123 124 125
56 12 16 20 22 30 38 53 58 60 79 89 106 107 113 115 116
57 1 2 3 5 6 8 9 10 14 15 16 17 20 22 23 24 26 28 29 31 32 34 35 36 38 39 43 45 46 47 48 49 50 52 53 54 58 65 67 69 71 72 74 77 78 80 84 85 86 88 89 90 91 93 94 95 97 100 103 105 108 109 111 112 113 115 116 117 118 119 120 122 123 124 125
58 1 2 4 6 7 11 13 14 17 19 20 21 22 23 24 26 27 28 30 31 36 37 40 44 45 46 47 48 49 50 52 53 55 57 59 60 62 63 66 68 70 71 72 73 74 75 76 77 78 79 83 84 86 88 90 93 95 96 97 98 99 100 101 103 104 106 112 113 114 115 117 118 119 120
59 17 19 20 29 32 37 39 40 57 58 77 78 82 87 123
60 2 3 10 15 17 43 48 49 53 55 61 62 64 65 68 71 73 75 76 77 90 95 98 99 101 105 106 118 119 121
61 10 11 12 15 18 20 26 28 29 33 38 41 46 51 52 54 63 66 68 69 71 79 84 95 102 106
62 2 3 4 5 8 14 15 17 23 25 26 27 28 30 34 37 38 40 43 46 54 56 63 64 65 67 68 71 73 76 79 81 87 88 89 93 94 98 102 103 104 110 111 112 115 118 122 123 124
63 6 11 13 14 15 17 18 19 20 21 25 26 31 32 33 35 36 38 39 41 42 43 44 50 52 54 65 66 68 69 70 71 73 74 76 78 81 83 84 86 87 89 93 96 97 100 104 106 108 110 111 115 116 117 118 119 120 123 124
64 2 4 9 11 12 16 21 24 28 30 31 34 36 37 39 40 42 48 49 55 57 62 63 67 76 77 81 83 93 94 103 104 105 125
65 5 7 8 9 10 11 12 17 18 19 27 28 29 31 33 37 43 44 46 47 49 50 52 56 57 60 64 66 67 69 70 71 72 73 75 76 77 78 80 87 89 90 94 100 103 109 111 112 113 114 118 121 122 123 124
66 2 5 6 7 13 14 16 20 22 23 24 25 28 29 30 35 37 41 42 45 46 50 51 56 57 63 65 69 74 75 80 81 87 88 90 91 92 98 99 105 106 108 109 110 111 112 116 122 123 125
67 1 2 3 5 6 8 11 12 17 18 19 21 25 26 28 30 31 32 33 34 38 41 43 44 45 46 47 49 50 52 54 55 57 60 62 66 68 69 70 71 73 74 75 76 78 79 80 84 87 89 90 91 92 95 96 97 100 101 102 103 104 106 107 109 113 116 117 118 120 121 122 124
68 39 42 43 47 58 84 97 103
69 3 4 6 9 14 20 24 30 31 34 47 48 53 55 60 61 62 64 73 74 83 88 92 95 96 98 101 102 110 113 114 116 124
70 2 4 9 11 13 26 30 32 33 34 35 41 42 45 48 50 51 53 58 61 62 65 68 74 78 79 81 83 85 86 89 90 97 99 101 102 105 106 107 110 113 116 123 125
71 7 11 12 13 17 18 20 21 24 25 26 41 44 45 46 47 48 56 57 63 64 67 68 69 76 77 80 82 84 86 88 89 92 96 105 106 107 108 110 111 112 113 114 115 116 119 123
72 1 36 43 83 100 104 110 116
73 1 2 4 6 7 8 10 12 13 14 15 17 18 20 21 23 25 26 27 30 32 35 37 41 43 47 48 49 53 54 56 58 59 60 61 62 63 64 67 69 70 71 75 77 78 80 82 84 85 86 88 89 90 93 94 95 96 98 99 100 102 103 105 106 109 111 113 115 117 118 120 121 122 123 125
74 3 10 49 52 53 69 72 101 112 116 119 122
75 3 6 7 8 9 10 11 13 16 18 20 22 23 24 25 27 28 29 32 33 35 37 39 43 45 47 49 53 55 56 57 60 62 63 65 66 68 71 72 73 74 76 77 78 79 82 83 85 86 88 89 99 105 106 110 118 122 123 125
76 41 55 105
77 3 6 7 10 12 13 15 18 19 20 23 27 28 31 32 33 35 36 38 39 43 47 51 52 53 54 55 57 58 60 61 62 63 65 67 68 72 73 74 81 84 85 86 89 92 94 95 96 97 98 99 100 102 107 109 110 113 114 115 117 118 119 122 123 125
78 8 40 46 48 54 59 66 91 104 105 111 118 120
79 1 21 38 51 52 96 105 124
80 1 2 3 4 5 6 7 9 11 13 15 16 18 19 20 21 22 23 24 25 26 27 28 29 30 31 32 33 34 35 37 40 42 43 44 45 46 48 49 51 53 54 55 56 57 58 60 61 62 63 64 65 66 69 70 71 72 73 74 75 76 77 78 79 81 82 84 86 87 88 91 92 93 94 95 96 97 98 99 101 102 103 104 105 106 107 109 110 111 112 113 115 117 118 120 122 124 125
81 1 2 4 5 6 7 8 9 10 11 12 13 18 21 22 25 26 28 29 30 31 33 34 36 37 38 39 40 41 42 43 44 46 47 48 49 50 51 52 53 55 56 58 62 63 64 65 68 69 71 74 75 76 77 78 79 80 83 84 86 87 89 90 91 92 93 94 96 98 99 100 104 105 108 109 111 112 114 116 117 118 119 120 122 123 124
82 1 4 7 11 12 14 15 16 17 21 22 26 27 29 30 33 38 39 46 49 53 55 60 64 66 68 70 74 75 76 86 91 92 98 99 108 110 112 116 119 120 123
83 3 5 8 10 11 12 15 16 17 18 20 24 26 28 31 32 38 39 42 48 49 54 56 57 59 60 61 62 66 68 69 71 72 77 78 81 82 84 87 88 92 96 97 98 100 101 110 115 117 118 120 121 123
84 1 3 4 6 7 8 9 10 13 14 16 20 21 22 26 30 32 33 35 42 44 46 48 52 59 61 63 65 69 75 81 82 83 86 88 89 96 101 103 110 111 115 116 123
85 9 10 12 13 17 18 22 23 27 28 29 30 39 41 45 47 48 52 53 54 57 64 67 71 75 77 79 83 84 86 88 92 93 94 96 98 99 101 102 103 104 106 110 111 112 113 119 121 123 124
86 1 3 4 5 6 10 13 17 18 27 36 38 44 46 48 50 54 59 60 62 67 68 69 70 75 85 87 92 93 98 104 105 106 115 118 120 121
87 3 7 10 12 18 21 29 30 40 42 43 51 52 64 66 67 74 80 84 97 104 107 108 112 117 120 124
88 2 4 11 12 34 44 61 82 83 86 92 94 121
89 12 16 44 55 68 69 96 100 102 108 116
90 1 4 6 7 8 9 10 11 12 13 14 15 18 19 20 23 24 25 28 29 30 32 33 34 36 37 38 39 40 41 43 44 45 46 48 49 51 52 53 55 56 58 59 60 61 63 64 65 66 67 69 70 71 72 73 74 75 76 77 78 79 80 81 83 84 85 86 87 88 91 92 93 94 96 97 98 100 101 102 103 104 105 106 107 110 111 113 114 115 116 117 119 120 121 122 123 125
91 82 119
92 11 15 22 23 28 29 33 36 43 44 57 61 70 72 79 80 90 103 105 113 119 124 125
93 1 6 10 13 14 19 23 27 28 29 30 33 42 48 51 55 58 60 62 64 65 71 72 73 75 78 81 82 86 87 91 97 100 106 108 110 112 114 116 117 120 121 123
94 47 87
95 3 7 9 12 13 22 26 27 28 29 31 33 34 36 39 41 48 50 55 57 58 59 61 65 69 70 71 73 74 76 85 91 92 93 98 99 102 103 108 109 113 120 121 123
96 36 85 92 123
97 43 53 61
98 1 2 3 8 9 10 12 14 16 20 22 24 25 26 27 28 29 30 33 38 39 40 42 43 44 45 46 47 48 50 51 53 54 55 56 57 58 59 60 61 63 65 66 68 69 71 73 74 75 76 78 80 83 84 85 87 88 89 90 91 93 94 95 96 99 101 103 105 106 107 110 113 114 115 116 118 119 121 122 123 124 125
99 2 15 37 68
100 1 18 20 25 33 36 40 101 123
101 2 3 4 5 7 9 11 12 15 18 24 25 26 27 28 30 31 34 37 38 39 42 44 49 53 54 55 58 59 62 63 65 72 73 75 76 77 79 82 83 86 87 89 90 91 93 94 95 97 99 100 102 103 104 105 108 109 110 111 113 115 117 119 120 121 122 124 125
102 22 24 52 87
103 4 6 12 22 29 30 31 32 33 36 38 39 47 49 53 55 63 70 72 74 78 83 87 88 90 94 95 99 100 101 108 109 112 114 118 120 121
104 2 4 5 6 8 10 11 13 17 22 23 29 30 31 35 36 37 38 39 40 48 49 53 55 56 57 61 62 63 64 66 68 69 71 73 75 78 79 80 81 85 86 88 93 94 103 106 112 113 117 120 123
105 1 2 3 4 11 13 14 15 16 23 32 33 34 40 46 47 48 50 51 53 55 56 57 58 59 62 69 70 71 73 76 77 79 81 83 86 87 89 90 92 95 99 102 104 106 108 109 113 118 120 121 122 123
106 5 14 18 20 21 23 27 31 35 43 44 48 50 51 52 54 55 57 59 66 67 68 71 73 74 75 78 82 85 86 91 92 98 101 103 105 114 117 119 120 124
107 4 34 36 52 64 96 98 124
108 1 3 6 7 8 9 10 14 15 16 17 18 19 20 22 24 25 26 27 28 30 31 32 34 36 37 38 39 40 41 43 46 47 48 51 52 53 54 55 57 58 59 60 61 62 63 65 67 68 69 71 72 73 74 76 79 80 81 82 83 84 86 87 89 90 91 92 93 96 97 98 99 100 101 104 105 106 111 112 113 114 117 119 120 121 123 124 125
109 6 29
110 1 2 11 13 15 25 43 44 54 62 82 89 93 102 103 112 124
111 1 2 3 4 9 10 12 13 16 17 19 20 21 22 24 27 30 31 33 36 37 38 40 41 42 43 44 45 46 49 52 54 57 59 60 61 63 64 65 66 67 68 70 71 72 74 76 77 82 83 84 85 88 90 92 93 94 95 96 97 99 100 101 103 107 108 110 112 114 115 117 119 120 122
112 2 6 8 9 10 12 13 14 17 19 20 24 26 28 30 31 36 37 38 39 42 43 47 48 51 52 54 55 56 60 66 69 72 73 74 82 86 87 90 92 93 94 95 96 97 100 101 105 106 109 110 111 114 117 122 124 125
113 1 3 7 10 11 14 16 17 19 21 22 25 26 30 31 33 34 36 38 39 40 42 43 44 46 48 55 56 57 61 72 74 81 87 92 98 99 102 104 105 109 116 125
114 43 103
115 23 33 34 42 44 70 103 119
116 1 3 4 5 6 7 8 9 11 12 13 14 17 18 21 24 25 26 30 32 33 34 35 36 37 38 39 40 41 42 43 45 46 47 48 50 52 53 55 57 58 61 63 64 66 67 70 72 73 76 77 78 80 83 86 87 88 89 90 93 94 97 98 99 100 101 102 104 105 106 108 110 111 112 113 114 115 117 118 119 120 122 123 124
117 2 6 11 15 22 24 31 40 57 64 68 69 74 77 78 79 86 90 91 96 100 108 110 113 114 116 119 125
118 2 4 5 6 7 10 11 13 14 15 16 18 20 21 25 26 28 31 32 33 40 41 42 43 44 45 49 51 53 57 59 61 62 64 66 69 71 72 73 74 75 76 78 79 80 83 84 86 89 92 93 94 95 96 97 99 100 102 103 107 112 113 117 125
119 63 74
120 3 5 9 15 19 21 22 28 32 34 37 41 45 46 50 51 56 58 60 68 71 73 74 77 89 91 93 95 99 103 123
121 1 3 5 6 7 10 13 14 15 18 20 22 25 31 35 38 40 50 53 54 55 57 58 61 65 66 69 72 73 74 75 76 77 78 80 81 84 90 91 99 102 107 114 123 124
122 5 10 18 20 25 29 33 37 38 47 53 71 72 80 85 92 95 100 103 104 117 121
123 5 7 8 11 12 18 20 21 22 23 26 27 31 32 35 37 38 48 49 52 53 54 59 60 63 71 72 74 80 81 85 87 89 91 93 95 102 103 105 109 110 111 112 114 115 118 121 125
124 6 8 9 15 22 27 29 31 33 34 38 42 50 53 74 88 91 101 106 108 112 114 117
125 3 4 6 12 13 23 24 25 26 27 29 34 39 44 46 50 56 61 64 69 71 73 77 78 79 82 85 86 87 92 99 103 105 109 110 121 124
