1 13 18 19 76 85 109 111 115 120
2 4 5 6 8 9 10 18 21 22 24 25 27 28 30 32 33 36 38 39 41 47 50 54 59 62 64 66 67 73 75 79 81 92 100 106 115 116 119 121 125 127
3 8 17 22 30 33 48 79 86 98 102 103 104 122 124
4 2 3 8 11 20 27 28 31 34 41 42 43 49 51 52 56 59 62 64 67 77 80 85 89 90 96 98 99 100 103 110 115 116 123 125 127
5 2 3 7 8 9 10 11 13 16 17 24 25 26 29 30 32 34 39 40 41 42 43 51 52 53 55 56 57 60 63 64 65 69 71 73 74 75 79 80 81 82 87 89 90 93 96 98 100 101 106 107 110 111 114 119 121 122 124 125 127 128 130
6 3 11 14 15 18 19 20 22 23 24 25 30 32 33 34 39 41 45 46 51 53 54 55 58 59 64 67 71 73 80 81 83 84 86 88 89 92 95 100 101 104 107 108 112 116 117 118 121 122 123 129
7 34 40 50 87 96 100
8 26 37 62 74 94 101 109 117
9 1 10 11 12 13 16 17 18 21 23 28 29 35 36 38 39 42 43 44 48 50 51 53 56 58 60 63 64 65 68 69 70 72 73 74 75 76 78 82 84 86 87 88 91 95 97 102 103 104 108 111 112 113 119 120 128 130
10 1 3 5 6 7 11 12 14 36 44 45 61 62 63 64 65 67 69 70 76 78 82 83 84 88 91 92 95 105 110 112 113 116 121 122 127 128 129
11 2 3 4 5 9 10 13 15 16 17 18 19 20 21 23 25 27 28 30 31 32 34 35 37 38 40 41 42 43 44 45 46 47 49 50 52 53 54 56 57 58 60 61 64 65 67 68 69 70 71 72 73 74 75 77 82 84 85 86 88 89 91 92 93 95 96 98 99 100 108 109 110 111 114 117 119 121 122 124 125 126 127 128 129
12 39 48 51 57 58 75 84 90 101 102
13 1 9 19 30 51 54 98 105
14 8 9 30 46 50 60 74 78 91 92 94 99 108 119 123 130
15 3 4 5 6 10 12 14 16 17 19 20 21 22 23 26 28 29 32 33 35 36 37 38 39 40 41 42 43 44 45 46 47 48 53 54 55 56 57 58 61 62 63 64 65 66 68 69 71 73 75 76 77 79 80 82 83 85 86 87 90 91 92 95 96 99 101 102 104 105 106 108 111 112 115 116 117 118 121 122 123 124 125 126 127 130
16 6 46
17 1 4 11 14 19 20 21 22 24 25 27 30 31 33 35 36 38 39 41 42 43 44 48 49 53 59 61 63 64 66 67 68 70 71 72 73 74 75 76 77 82 84 85 86 87 88 89 95 96 97 102 106 107 110 113 114 117 123 124 125 126 127
18 1 2 3 4 5 7 10 11 14 17 19 20 21 23 24 25 26 29 31 32 33 34 35 37 39 41 42 43 44 45 47 52 55 59 60 67 69 71 75 77 80 81 84 85 86 87 88 94 95 96 97 98 99 102 103 104 106 108 109 110 117 118 120 121 122 125 126 127 129 130
19 1 2 4 5 6 7 8 9 10 13 14 15 16 20 21 23 24 25 27 28 30 31 32 33 34 35 36 37 38 41 43 44 45 46 50 51 52 54 56 58 60 61 62 64 65 66 68 69 72 73 74 76 77 78 79 80 81 82 83 84 87 88 89 90 91 92 94 96 98 99 100 102 104 106 107 108 109 110 111 112 113 116 117 119 120 122 128 129
20 8 9 14 17 18 22 23 25 26 29 31 41 43 49 50 53 58 59 60 67 68 72 80 83 96 111 113 127 129
21 1 2 3 5 8 9 11 15 16 17 18 19 20 22 25 28 35 52 55 57 59 61 63 66 69 71 74 77 78 79 81 87 88 89 91 92 97 98 100 105 112 113 115 116 118 121 123 125 129
22 1 2 3 5 6 7 9 10 11 13 14 15 17 18 21 23 24 25 26 27 28 29 30 31 32 33 34 36 37 39 41 43 44 48 49 51 52 53 55 56 57 58 59 60 61 62 64 69 70 71 74 78 79 80 81 82 83 84 85 86 88 89 91 93 94 95 96 97 98 99 100 101 103 104 105 106 107 108 109 110 111 112 114 117 118 119 120 121 123 124 125 126 127 128 129 130
23 1 60 72 79 97 98
24 4 6 10 11 12 15 16 17 19 21 22 23 26 28 30 31 32 34 35 36 37 38 41 43 44 46 47 49 52 54 55 57 58 59 62 63 66 68 69 71 72 77 79 81 83 86 87 88 93 94 95 96 98 99 100 101 103 107 108 111 112 114 115 118 119 123 127 128 129 130
25 49 56 115
26 42 109 125
27 1 2 3 4 5 6 8 9 10 11 14 15 17 18 20 21 23 25 26 30 32 33 34 35 37 39 41 44 45 46 47 48 49 50 51 52 53 55 56 58 59 60 61 62 63 64 65 66 68 69 70 71 72 73 74 75 77 79 80 82 83 84 85 86 87 88 89 90 91 92 94 95 97 98 99 101 102 103 104 105 106 108 109 110 112 113 114 115 116 117 118 119 122 123 124 125 126 127 130
28 16 23 32 44 88 90 96 97
29 7 12 13 18 21 23 37 39 44 45 51 53 57 58 63 72 76 78 84 92 94 102 104 105 107 108 109 112 119 121 124
30 38 50 59 93 96 114 115 125 128
31 17 95
32 21 85 118 126
33 11 12 42 47 48 60 62 65 69
34 5 9 10 11 15 19 21 26 30 37 39 42 47 57 64 65 74 75 76 79 81 84 88 98 104 111 112 114 119 125 126 127
35 4 9 13 15 20 26 27 34 39 41 42 43 46 47 52 55 56 57 60 61 70 73 74 77 78 79 82 83 85 90 93 96 104 111 113 116 121 124 125 126
36 5 23 28 30 35 45 49 60 65 66 82 88 109 116 121 123
37 21 89 92
38 6 20 41 46 48 54 61 64 66 74 76 87 96 101 126 128
39 18 19 24 31 32 56 57 70 82 83 87 89 101 103 107 109
40 13 18 23 26 27 36 41 43 55 64 69 72 78 81 90 101 106 112 115 118 121 123 127 128 130
41 3 4 5 6 8 12 14 15 17 18 20 23 24 27 29 32 37 39 48 51 53 54 56 57 60 61 64 69 70 71 72 73 75 77 78 80 81 84 86 87 88 89 90 92 94 96 99 100 102 105 106 107 108 109 110 111 113 114 122 125 127 128 129
42 2 4 6 8 11 12 14 17 18 20 21 23 25 27 29 31 32 33 34 38 39 44 46 48 49 50 51 53 55 58 59 62 63 64 65 66 67 68 69 72 75 77 78 79 80 81 82 84 86 87 90 92 93 96 97 99 101 102 111 113 114 117 118 119 120 122 127 129
43 1 5 8 9 11 15 17 20 21 25 27 30 31 32 36 38 39 42 52 61 62 63 64 67 73 76 85 90 91 92 94 99 100 101 103 104 109 112 113 114 122 123 124 128
44 77 106 119
45 3 5 6 7 13 15 16 17 18 19 21 22 23 24 25 27 30 33 34 38 40 42 43 44 48 50 52 53 55 58 59 61 64 65 69 70 71 73 74 78 79 83 84 86 91 93 94 95 99 101 102 104 105 109 110 111 113 114 116 117 118 121 122 123 127 129 130
46 9 16 18 23 33 39 49 51 53 56 62 73 75 76 79 90 95 102 104 114 116 117 118 120 125 127 128
47 7 46 70 81 103 121
48 17 52 55
49 29 43 50 76 85 123 127
50 1 2 3 4 5 7 8 15 18 19 24 29 31 35 36 38 39 42 44 48 51 53 54 55 56 57 59 61 65 67 70 71 76 79 83 84 86 88 89 90 91 94 95 97 98 100 101 103 109 117 120 121 125 127 128 129
51 1 3 15 19 30 39 45 98 112 118 120 122
52 8 26 63 66 97 111 129
53 37 41 96
54 20 25 28 31 44 53 56 67 75 95 101 106
55 5 16 17 28 35 37 42 52 91 92 96 104 106 109 110 112 113 122 123
56 20 23 24 28 35 36 45 47 68 69 74 75 79 82 85 86 89 90 92 96 107 110 112 115 117 124 128
57 3 5 6 9 12 26 27 28 29 30 39 44 51 56 59 62 67 71 76 78 79 80 84 92 93 101 122 130
58 5 53 82 100 118
59 5 8 16 20 23 30 31 33 37 40 57 61 66 72 82 86 87 92 98 113 114 125 127
60 17 33 34 43 55 61 65 66 70 93 95 105 114 115 117 130
61 1 17 26 29 50 56 57 68 72 75 76 82 93 97 113 114 115 125 127
62 7 25 30 44 45 65 72 75 79 88 109 110 120 123 125
63 9 10 20 24 25 30 33 35 37 55 73 74 77 78 81 90 94 106 107 123
64 5 25 29 32 34 65 67 74 85 87 102 104 127
65 4 9 10 15 23 27 32 36 42 43 48 52 58 60 62 64 68 69 72 78 79 80 81 86 95 103 110 112 115 120 121 126 129
66 44 101 103
67 4 6 8 12 17 20 23 26 28 31 66 70 81 96 100 116 118 122
68 45 51 74 127
69 7 55 70 101 112 125
70 1 7 12 15 19 23 25 26 27 30 31 34 36 37 40 42 46 52 53 55 57 63 73 76 81 82 83 84 95 110 113 115 117 121 122 123 125 130
71 4 8 9 15 16 28 29 33 34 37 43 53 54 55 61 62 68 73 76 84 85 88 90 91 111 115
72 1 3 5 6 11 12 15 16 17 20 22 24 29 31 32 37 40 42 46 53 55 59 64 65 66 67 76 77 80 81 83 91 92 97 99 100 101 102 103 104 108 109 112 113 115 117 119 123 125 126 129 130
73 3 5 7 12 14 15 18 19 20 22 29 31 35 37 42 48 49 51 52 55 57 58 60 61 62 63 67 68 69 70 74 75 80 82 86 87 89 90 91 94 96 97 99 104 107 109 110 111 117 118 119 121 128 130
74 1 3 5 10 11 12 15 17 18 19 20 21 23 25 26 32 33 34 36 37 38 39 40 41 45 46 48 49 50 51 54 57 59 63 64 68 73 77 78 79 82 83 84 86 89 90 91 93 98 99 101 103 104 108 110 114 116 118 119 120 122 124 125 127 128 129
75 3 6 8 14 18 19 20 25 26 36 43 44 48 56 57 58 59 61 68 69 70 80 87 88 96 102 104 108 121 127
76 11 27 31 41 91 100 107
77 11 13 14 25 31 52 54 94 97 100 102 124 125
78 56 129
79 1 8 22 23 24 31 35 36 47 48 50 53 61 68 72 73 87 94 95 99 111 113 114 115 116 117 118 119 122 128
80 3 15 16 19 40 56 60 126
81 1 2 6 10 14 18 24 26 28 31 32 35 36 38 40 41 52 56 58 64 67 68 69 71 78 79 80 83 85 87 88 93 97 99 104 109 111 115 121 123 130
82 1 3 4 5 7 8 11 14 15 16 18 19 20 22 26 28 29 30 32 36 37 39 40 44 45 46 48 49 50 55 60 61 62 66 69 70 73 74 75 77 78 81 87 88 89 90 91 92 94 95 97 98 102 103 104 105 107 108 114 116 117 118 120 121 122 125 127 130
83 10 12 23 35 42 45 57 69 70 87 100 120 125
84 5 10 14 15 28 62 88 126 127
85 32 70 77 123
86 2 3 5 6 7 8 9 11 12 13 14 15 16 17 18 19 20 21 22 23 24 26 27 28 29 30 31 32 33 34 36 38 39 40 41 42 43 45 46 47 50 51 53 54 55 58 59 60 61 62 64 67 68 69 70 71 72 78 79 80 82 83 84 87 89 90 91 92 93 94 96 100 101 102 103 104 105 106 107 108 109 110 111 112 113 114 115 116 117 119 120 121 122 123 126 127 128
87 1 15 18 24 30 41 46 60 63 64 66 67 74 76 79 83 84 86 89 91 97 101 105 117 118 127 128
88 9 10 11 13 16 18 19 23 25 26 27 29 30 33 34 36 38 41 42 44 48 50 51 52 55 56 59 60 62 64 66 67 70 71 75 76 77 80 82 83 86 89 102 106 107 109 111 112 115 117 119 120 123 126 129
89 1 2 8 11 13 16 23 24 25 27 29 32 41 44 50 53 56 58 61 63 66 74 77 79 80 81 82 92 93 94 96 101 105 108 111 112 115 116 120 121 122 127 128
90 6 7 14 34 40 48 51 52 101 110 118 125 129
91 75 100 106 119
92 15 16 71 125
93 4 5 7 13 15 16 20 21 24 28 30 31 34 36 37 38 40 41 43 45 46 47 48 51 52 54 57 58 59 61 65 66 67 68 69 71 73 75 77 79 80 82 84 85 89 90 94 98 99 101 106 109 110 111 112 114 115 116 118 119 120 129
94 1 2 6 7 10 12 18 20 21 23 26 28 31 32 35 40 41 42 43 44 46 48 49 51 53 54 55 56 57 58 60 61 62 63 65 67 68 71 79 80 81 82 83 89 90 91 93 96 97 98 100 101 102 103 104 105 107 108 109 110 111 112 115 116 118 120 124 125 126 127
95 1 2 3 4 6 8 9 11 17 18 19 20 21 22 25 28 30 32 35 40 42 44 47 49 51 53 54 58 59 60 61 62 65 69 71 72 73 74 77 78 83 84 86 87 88 92 93 97 99 101 103 105 107 108 109 110 113 119 120 121 122 123 124 125 126 127 129 130
96 2 6 16 18 28 33 43 52 63 68 81 89 94 107 114 129 130
97 32 93
98 1 3 13 16 18 30 33 35 36 40 41 43 44 47 56 59 62 75 76 81 83 86 89 93 99 107 110 116 121 125 126
99 13 16 24 27 30 45 49 53 64 77 88 107 116 118 127
100 9 28 66 72 83
101 4 7 9 10 11 13 15 16 19 23 29 31 32 33 34 36 38 42 43 44 48 49 56 58 59 64 65 67 68 69 70 71 76 78 83 84 90 95 103 105 106 107 109 110 113 115 118 119 120 122 123 124 128
102 2 17 27 39 46 49 63 64 67 78 87 88 95 98 110 114
103 5 45 51 65 123
104 3 9 12 14 15 19 29 35 37 38 42 65 67 68 69 74 81 91 103 105 115 119 121 125 126
105 43 71
106 2 4 11 12 14 16 17 19 21 22 29 30 32 37 42 44 49 51 54 60 61 66 68 69 70 72 73 80 81 86 88 89 90 93 95 96 102 104 105 109 110 111 112 114 115 117 118 119 120 122 126 127 128 129
107 3 14 22 25 28 29 30 38 52 57 58 59 66 74 77 82 84 85 86 88 92 96 97 98 103 104 106 108 111 112 113 117 118 119 124 128 130
108 7 52 78 82 104 127 129
109 3 11 12 18 26 32 38 50 56 66 78 81 86 89 92 106 111 112 121
110 23 44 49 52 57 67
111 7 8 10 11 12 31 32 39 41 43 49 54 62 75 93 95 98 101 102 104 106 108 120 122 124 127 130
112 25 38 43 90 97 119 125
113 5 7 10 14 18 23 29 31 34 35 36 39 43 49 50 59 60 61 62 65 70 71 73 74 77 79 80 81 82 83 88 89 93 98 102 104 105 110 112 114 115 127 129
114 6 20 26 36 40 41 67 83 91 101 113 116 120 129
115 1 2 4 5 11 13 14 15 16 17 18 21 29 32 34 35 37 38 40 41 42 43 44 50 51 52 53 58 59 60 61 62 63 64 66 67 68 69 71 72 73 75 77 78 81 82 83 85 88 90 93 94 97 98 99 100 102 103 105 106 111 113 114 116 117 118 121 122 124 125 127 129 130
116 43 69
117 1 2 3 4 5 7 8 10 11 14 15 16 17 18 19 20 21 22 23 24 25 26 27 28 30 31 32 33 34 35 36 38 39 40 41 42 43 45 46 47 48 49 50 51 52 53 54 55 57 58 59 61 62 63 64 65 66 67 68 69 71 73 74 75 77 79 80 81 82 83 84 85 86 87 88 89 90 92 93 94 96 97 98 100 101 102 103 105 106 107 108 109 110 111 112 113 114 115 116 118 119 120 121 122 123 124 125 126 128 129 130
118 1 3 9 10 14 17 18 19 20 21 23 24 30 31 32 35 36 38 39 40 41 42 43 44 46 48 49 53 54 55 57 58 59 60 62 65 71 74 75 76 77 79 81 83 84 85 89 92 93 94 95 99 101 105 109 111 114 116 120 121 123 124 125 130
119 2 3 4 5 7 8 10 11 12 13 14 15 16 17 18 19 20 23 29 30 31 35 36 40 42 44 45 48 50 52 54 57 59 61 62 64 67 69 75 76 78 81 83 86 88 89 93 95 99 100 101 102 103 104 109 113 116 118 120 121 123 125 126 127 129 130
120 2 7 8 13 14 15 18 20 23 28 32 36 37 44 46 48 49 51 54 59 60 65 69 75 83 84 88 91 92 104 108 110 125 126 129 130
121 1 3 4 5 6 7 8 9 11 12 13 15 16 17 18 19 20 21 23 24 25 27 28 29 30 31 32 33 34 36 37 39 40 41 42 43 44 45 46 47 48 49 50 51 52 53 54 55 56 57 60 62 63 64 65 66 67 68 69 70 71 72 73 74 75 76 77 78 79 80 81 82 83 85 86 87 88 89 90 91 92 94 96 97 98 99 100 101 102 103 104 105 106 107 108 109 110 111 112 113 114 115 116 117 118 119 120 122 123 124 125 126 127 128 129 130
122 4 77 80
123 17 23 25 50 70 73 75 89 92 101 107 112 118 122 125 129
124 37 51 54 66 71 102 110 127
125 2 4 5 6 7 8 9 10 12 13 14 15 16 17 20 21 22 24 25 28 30 32 33 34 35 36 39 41 42 43 44 45 46 48 49 50 51 52 54 55 57 58 60 64 69 71 72 74 75 76 77 78 79 80 81 85 86 88 89 90 91 92 93 94 96 99 100 101 102 104 105 106 107 108 109 110 111 112 113 114 115 116 117 118 119 120 122 123 124 126 127
126 2 6 36 45 61 75 83 84 85 90 96 98 104 109 110
127 16 38 46 60 62 67 73 82 93
128 5 97 102
129 4 16 17 19 20 23 24 28 30 33 34 35 36 37 59 66 67 69 72 77 78 81 84 85 94 98 101 106 107 113 115 119 121 122 128
130 16 32 45 49 58 60 67 78 93 107 112 116 126 129
