1 15 23 52 62 65 73 74 77 78 92 96 112 117 132
2 6 10 11 12 13 18 23 27 28 29 33 38 41 44 51 52 53 54 55 56 62 64 70 78 82 84 85 87 89 91 92 93 96 97 98 100 105 108 109 111 116 117 124 125 127 129 131 133
3 1 35 72 102 103
4 1 2 3 5 7 8 9 11 12 13 14 15 18 19 21 22 23 24 27 29 30 31 33 34 35 38 40 41 43 44 45 48 51 52 53 55 57 58 59 61 64 65 66 68 69 70 72 73 76 77 78 79 80 81 84 87 89 90 91 92 93 94 95 96 97 98 99 101 103 106 107 108 110 112 113 114 115 116 118 119 120 121 123 126 127 129 132 133 134 135
5 20 76 95 108 126
6 1 5 10 11 13 15 16 18 25 26 31 35 38 43 44 45 46 48 51 56 58 61 65 69 78 79 81 87 89 90 92 95 97 98 100 101 102 111 112 115 119 120 123 132 133 135
7 3 4 6 10 11 13 15 17 18 20 21 22 25 26 27 28 29 30 32 35 38 40 41 43 44 45 46 47 51 52 54 55 56 58 59 62 63 64 66 67 69 70 76 79 81 82 88 91 92 93 99 101 102 103 105 106 107 108 109 110 114 115 116 118 120 121 123 126 127 128 129 130 134
8 5 13 14 19 26 27 28 29 32 39 54 59 66 69 78 83 88 91 94 116 129 130
9 2 7 10 12 13 15 16 26 32 34 36 37 38 39 41 46 51 52 53 54 56 58 59 63 64 65 66 67 69 70 74 75 76 77 80 81 83 84 85 86 90 91 93 94 96 97 98 99 101 102 103 104 107 112 113 114 115 117 118 121 124 125 126 127 135
10 8 17 26 29 30 36 41 43 54 56 77 93 99 112 113 116 118
11 23 54 100
12 1 2 4 6 19 28 31 39 44 46 47 51 55 56 59 64 69 71 79 85 91 92 98 100 102 106 109 115 123 125 126 133
13 3 5 10 11 14 38 43 44 80 81 101 116 121 124
14 11 19 21 26 29 30 31 35 50 59 68 76 89 95 103 107 110 116 121 131
15 2 4 6 8 10 11 13 17 19 22 24 26 27 28 29 35 37 41 42 44 46 47 48 50 54 58 60 61 64 67 68 69 71 73 75 77 82 83 86 87 88 89 91 96 99 100 101 102 113 117 121 122 123 126 129
16 10 58 80 107 124
17 51 56 57 59 64 66 72 75 77 94 99 100 122 126 129 132
18 26 67 103 129
19 4 17 18 20 23 28 29 32 33 36 40 43 44 46 47 48 52 54 57 60 74 82 87 91 93 95 98 101 102 104 110 113 115 119 120 127 132
20 1 2 4 5 6 9 10 11 14 15 17 19 21 22 23 24 25 29 30 31 32 33 35 36 37 39 44 46 47 51 52 56 57 58 60 61 62 63 65 67 69 70 72 73 74 76 77 80 82 83 85 86 88 89 91 92 93 97 99 100 101 102 104 105 107 109 111 112 113 114 116 117 118 121 123 125 129 131 133 134 135
21 16 45 77 80 82 118
22 50 88
23 9 11 12 15 17 22 42 43 44 48 59 61 62 63 68 84 87 94 96 105 106 110 111 112 115 116 124 125 126 129 130 132 134
24 1 2 3 4 5 10 12 16 18 19 20 21 22 23 25 26 28 29 33 35 36 40 45 46 48 49 56 57 58 59 62 65 66 67 68 69 72 73 74 76 79 80 81 82 85 87 88 90 93 94 96 99 103 104 105 106 107 108 109 110 113 114 116 118 122 123 124 125 128 129 130 132 134
25 3 34 36 39 47 68 72 121
26 1 2 4 7 8 9 10 13 14 15 20 21 25 28 29 30 33 34 35 36 37 38 39 40 41 42 43 45 48 49 51 52 53 54 55 56 58 60 61 62 66 69 71 72 74 75 76 77 78 79 85 86 89 93 95 97 98 99 101 102 103 104 105 108 110 115 116 119 120 124 125 126 127 130 131 133 134
27 31 46 81 127
28 57 105 125 127
29 1 5 7 12 17 20 21 23 24 25 26 27 30 31 33 34 39 44 45 51 52 53 54 55 57 58 61 62 63 64 65 66 69 70 71 74 79 80 83 88 89 90 93 95 96 98 100 101 103 104 105 109 112 113 115 119 128 129 130 132 134 135
30 1 2 11 26 28 35 39 41 50 55 74 78 82 83 89 90 91 96 109 111 113 114 121 128 129
31 19 26 35 41 58 64 66 68 73 74 87 88 93 100 101 105 114 117 118 120
32 7 23 28 30 95 118 129 134
33 4 37 118
34 2 11 22 23 28 31 36 42 47 51 53 94 95 102 108 112 114 117 119 122 123 126 132
35 7 15 17 22 26 30 32 44 46 57 59 63 65 66 73 79 80 83 95 100 111 118 129 131 133 134
36 48 91
37 3 13 23 26 50 70 83 86 97 108 115 122 124 126
38 5 8 9 10 12 13 17 18 24 27 28 30 34 47 49 51 54 55 57 59 62 65 69 70 71 73 80 81 84 90 94 101 104 107 110 111 116 117 118 122 128 130 135
39 1 2 3 4 5 6 7 8 10 11 12 13 14 16 17 19 20 21 22 23 24 25 26 27 29 30 32 33 35 36 37 38 40 41 42 43 44 45 46 48 49 50 52 53 54 55 56 57 58 59 62 63 64 65 66 67 68 70 71 73 74 75 76 78 79 80 81 82 83 84 85 86 87 88 89 90 91 93 94 95 96 98 101 102 103 104 105 106 107 108 109 111 112 114 115 116 117 118 119 120 121 122 123 124 125 126 127 128 129 130 131 132 133 134 135
40 6 10 65 114
41 2 5 9 11 27 39 42 49 58 60 62 73 74 82 83 86 88 101 104 108 112 117 119 120 128 129
42 1 3 4 5 6 7 8 9 11 12 21 26 28 33 34 35 38 39 46 48 51 54 59 60 61 63 65 66 67 70 71 72 73 75 76 79 80 81 82 84 86 91 95 96 97 99 100 104 106 107 109 111 112 114 115 118 123 124 125 126 127 128 129 131 134
43 8 10 11 12 13 14 16 18 20 22 23 26 27 33 34 35 36 37 41 42 46 47 51 53 55 57 58 62 63 65 66 68 71 73 74 76 77 79 80 81 82 83 84 91 92 93 94 95 99 101 105 106 107 108 111 114 115 117 118 119 122 123 124 127 129 132 134
44 3 47
45 7 12 13 15 34 80 81 84 93 96 101 122 130 132
46 2 6 7 10 12 14 15 16 17 19 20 21 23 26 28 44 48 50 57 63 64 68 72 75 89 91 95 106 108 109 110 111 112 114 116 118 120 121 123 126 132
47 3 12 15 18 19 20 22 29 30 33 34 49 51 52 67 69 73 77 79 82 83 85 91 93 104 108 113 119 125 127 128 130
48 1 2 3 7 8 9 10 11 12 14 15 16 18 21 22 23 24 25 26 27 29 32 33 36 37 38 42 43 45 50 51 54 57 58 59 60 61 62 64 66 68 69 70 72 73 74 75 77 80 81 82 85 86 87 88 92 93 94 95 96 97 98 99 104 105 106 109 110 111 112 113 114 116 117 120 121 125 126 128 131 132 134
49 21 32 36 40 42 53 103 107 115 126
50 2 3 6 11 16 23 27 28 29 33 43 44 54 66 79 83 88 93 95 104 105 112 113 129
51 1 2 3 4 5 6 7 9 10 11 12 13 14 15 16 17 18 19 20 21 22 23 24 25 26 27 28 29 30 32 33 34 35 36 37 38 39 40 41 42 43 44 45 46 47 48 50 52 53 54 55 56 57 58 59 60 61 62 63 64 65 66 67 68 69 70 71 72 75 76 77 78 79 81 82 83 84 85 86 87 89 90 92 93 94 95 96 97 98 99 100 101 102 103 104 105 106 107 108 109 110 111 112 113 114 115 116 117 118 119 120 121 122 123 124 125 126 127 128 129 130 131 132 133 134
52 1 4 8 14 15 17 24 27 30 33 41 42 45 46 54 57 72 78 86 90 94 95 97 100 102 109 110 111 117 119 125 127 129 131 133 135
53 3 4 5 7 8 9 10 11 12 13 14 15 16 17 18 20 22 24 25 26 27 28 29 31 32 33 41 42 43 44 45 48 49 50 51 52 54 56 57 61 62 63 64 65 66 67 69 72 73 78 79 81 82 85 86 87 88 89 90 91 92 95 96 97 98 99 100 102 103 104 105 107 109 110 112 113 114 115 117 119 121 122 125 127 128 130 131 135
54 1 2 5 6 7 9 10 11 12 16 17 18 19 20 22 24 25 26 27 28 29 33 34 35 36 38 39 40 41 44 45 46 47 49 51 52 55 57 58 59 60 62 63 66 67 70 71 74 75 77 78 80 81 84 85 86 87 88 89 90 91 92 94 97 99 100 103 105 106 110 111 113 114 115 119 121 122 126 127 128 130 135
55 5 48 74 81 87 88 97 108 123 126
56 1 2 5 8 10 12 14 17 19 20 21 23 24 28 31 32 34 35 36 39 41 42 43 44 45 46 47 49 52 53 54 55 57 59 60 61 62 63 64 66 67 68 69 70 72 73 74 75 77 79 80 81 85 86 89 91 92 93 94 95 98 102 105 106 108 109 110 111 112 114 115 116 118 119 122 123 124 126 127 128 129 130 132 134 135
57 3 10 36 49 54 70 80 81 85 104 106 116 121
58 6 18 26 27 50 51 61 71 96 103
59 39 85 129
60 1 2 3 4 5 7 11 12 13 16 17 18 19 21 23 24 25 28 30 31 32 34 38 39 41 42 44 46 48 52 53 54 55 56 59 61 62 63 64 65 68 69 70 71 74 75 77 78 79 80 81 84 85 86 88 89 91 92 98 99 100 101 102 104 106 108 110 111 113 115 117 121 122 123 126 127 128 130 131 134 135
61 7 16 18 19 23 25 36 42 46 47 49 52 53 54 59 62 69 70 71 73 75 77 79 80 83 84 87 90 91 97 98 99 100 101 102 104 107 112 114 116 118 119 121 124 128 129 133
62 2 5 7 8 9 11 12 13 14 15 17 19 20 21 26 27 31 34 36 37 38 39 40 41 42 43 44 47 49 51 52 55 58 59 60 61 63 64 71 72 73 74 76 77 78 79 82 83 84 87 88 92 94 96 97 98 100 102 103 104 106 107 108 110 111 112 113 114 115 117 118 119 120 121 122 125 126 130 131 132 133
63 2 4 5 7 9 11 13 17 22 24 25 26 28 30 31 35 38 41 44 47 49 51 52 53 54 55 56 57 59 64 67 69 70 72 73 74 79 81 82 84 85 86 87 88 91 92 99 101 103 108 112 113 114 117 125 126 127 130 131 132 134
64 8 10 13 14 18 28 29 34 38 44 54 61 65 74 77 82 90 91 92 93 94 97 100 103 115 118 121 125 126 135
65 79 99
66 2 4 5 6 7 8 11 12 13 14 15 16 17 18 19 21 22 23 25 26 27 28 30 31 32 33 34 35 38 40 42 43 44 45 47 48 49 53 54 57 58 59 60 62 63 64 65 67 69 70 71 72 73 78 80 81 82 83 84 85 87 88 89 90 92 93 94 95 96 97 98 99 102 103 105 107 109 112 115 116 117 118 119 121 122 123 124 126 127 128 129 130 132 134
67 58 66 87 98 122
68 3 10 17 18 55 56 85 89 96 101 115 117 119
69 17 21 25 37 57 58 70 93 96 103 107 122 128 132 135
70 4 10 11 13 18 21 30 32 35 36 39 43 44 48 52 54 58 62 65 67 69 82 86 87 90 92 98 100 101 104 105 107 108 110 112 114 118 120 122 123 134 135
71 26 88 115
72 3 4 5 7 8 9 10 12 14 15 16 17 19 20 21 24 25 31 32 33 35 39 40 42 43 44 45 47 48 50 52 53 55 57 58 62 63 64 67 73 74 77 78 80 81 82 83 84 88 89 98 103 106 107 110 112 115 116 118 120 122 124 126 127 131 133
73 5 8 13 43 46 51 65 87 94 99 107 108 118 121 123 129 131
74 4 10 11 12 14 16 17 27 32 34 37 41 47 50 53 54 58 59 60 64 70 71 73 77 80 81 82 85 86 87 88 94 95 96 97 103 105 107 108 110 113 114 117 118 119 120 121 129 130 131
75 76 122
76 1 4 5 14 17 22 27 29 30 42 43 46 50 56 61 63 71 84 85 93 94 95 102 108 109 113 118 119 121 122 124 125 131 133 134
77 2 4 6 7 13 18 19 21 22 25 26 27 29 31 34 39 48 49 59 61 65 68 70 73 75 78 81 85 91 93 97 98 102 105 109 116 118 123 124 125 129 132 134 135
78 1 3 12 134
79 3 5 6 8 9 10 15 18 22 30 32 33 34 36 41 47 48 49 52 53 54 55 58 60 61 65 66 67 78 81 82 83 84 85 86 95 98 99 100 101 103 106 121 122 124 125 127 131
80 4 6 8 20 33 34 35 41 42 46 48 49 56 57 59 63 65 66 77 81 83 84 87 88 91 92 93 98 115 128 130
81 1 2 3 4 6 7 9 10 11 12 13 15 21 22 23 25 26 29 30 31 33 34 35 36 37 39 40 41 42 44 47 48 50 51 52 53 54 58 60 61 63 64 65 66 69 73 74 76 78 79 80 83 85 86 88 89 90 91 94 95 97 98 102 103 104 105 109 110 111 112 113 114 116 117 119 121 122 123 126 128 129 130 132
82 1 20 29 73 84 94 98 102 103 123
83 12 118 124
84 1 2 3 4 7 9 10 11 12 14 15 16 18 19 21 23 24 25 26 27 28 29 30 31 32 34 35 36 37 39 40 41 42 43 46 47 48 49 50 51 53 54 55 56 57 58 60 62 64 65 67 72 73 75 76 77 78 79 80 82 83 87 88 89 90 92 93 94 97 98 99 101 102 103 104 106 107 108 109 111 112 113 115 116 117 119 121 122 123 124 128 129 130 133 135
85 1 5 8 9 13 14 16 27 29 36 39 42 56 68 69 73 77 82 97 99 100 106 107 113 116 119
86 3 4 6 9 11 21 23 26 33 39 47 48 56 64 74 76 79 93 95 97 111 114 117 121
87 1 4 6 14 15 17 20 21 30 44 45 51 53 62 64 68 75 82 83 93 97 102 104 108 109 114 123 124 128 131
88 28 36 38 53 62 68 76 77 85 105 118 120 122 125 126 128 133
89 21 37 45 58 62 65 78 94 113 125 131 132 134
90 8 18 27 36 40 46 69 80 116
91 2 3 4 5 6 7 8 9 11 12 13 14 15 17 18 20 21 24 25 26 27 28 29 30 31 32 33 34 35 36 38 39 40 41 42 43 44 45 46 47 48 49 50 51 52 53 54 55 56 58 59 60 62 63 64 65 66 67 68 70 71 72 73 74 75 76 78 79 80 81 82 83 84 85 86 88 89 90 93 94 95 96 97 98 99 101 102 103 104 105 106 107 108 109 110 111 112 113 114 115 116 118 120 121 122 123 125 127 129 130 131 132 133 134 135
92 10 22 77 85 95 110 131 134
93 3 4 5 11 12 16 17 18 19 20 25 27 28 29 32 37 38 39 43 46 48 49 51 54 55 59 60 62 63 64 67 68 70 71 73 76 77 78 79 80 82 83 84 88 90 92 96 97 98 100 103 104 106 111 112 113 114 115 116 119 120 122 127 128 129 131 132 133 135
94 4 23 30 34 37 42 44 51 55 66 70 71 73 77 92 93 98 99 102 108 110 116 125 128 132 133
95 1 3 4 6 7 8 9 12 13 14 15 16 18 19 22 24 25 28 29 30 31 34 35 37 38 39 42 44 45 47 48 49 51 52 55 56 64 65 67 68 70 71 73 75 77 78 79 80 83 84 86 87 89 90 93 94 97 98 100 101 102 103 105 106 111 112 113 115 118 119 121 122 123 124 125 126 127 128 129 131 132 133
96 8 15 17 25 28 31 36 38 43 45 46 48 53 55 61 65 67 69 71 85 89 91 92 101 108 110 112 113 118 119 122 124 128 131 134
97 6 11 13 15 19 20 24 26 29 34 37 39 47 49 52 53 55 57 62 68 73 79 80 81 98 100 102 107 114 118 123 125 133
98 4 8 9 22 30 35 37 39 40 67 87 90 91 95 97 101 110 112 115 129
99 3 4 5 6 10 11 13 14 16 17 19 20 23 25 26 27 28 29 30 31 33 34 35 36 37 38 39 40 41 42 43 44 45 47 48 52 53 54 55 58 59 62 63 66 69 70 71 72 73 74 75 76 78 79 80 81 85 87 88 89 90 91 92 93 94 97 105 106 107 109 111 112 114 115 116 121 122 123 124 125 126 127 128 129 130 132 133
100 15 16 18 19 22 24 43 46 61 64 68 69 74 88 99 115 122 128 129 130
101 1 4 7 9 10 15 18 19 21 23 27 37 38 39 41 43 44 47 49 50 51 62 67 69 71 73 76 77 79 80 81 84 86 87 88 89 90 95 97 98 99 108 110 112 114 117 118 119 121 129 132 133 134
102 2 3 7 9 10 22 23 24 26 27 33 42 45 46 50 52 54 60 64 69 70 73 74 78 79 80 94 96 98 101 105 109 115 117 118 121 126 131 132
103 4 7 16 18 20 25 26 28 34 39 40 41 54 55 64 66 71 75 78 82 84 87 93 111 114 115 117 122 123 129 132 133 135
104 2 3 9 14 16 17 19 20 25 29 35 36 39 42 49 53 56 62 63 65 66 78 83 84 86 95 97 98 99 109 110 114 115 116 117 121 125 126 127 128 129 131 134
105 1 8 16 25 26 29 41 44 49 50 53 54 58 61 66 70 71 78 79 80 82 88 99 124 126 127 135
106 1 6 9 12 14 17 20 22 23 24 32 34 36 38 43 44 49 50 53 54 66 68 70 76 79 86 90 93 94 96 97 98 103 105 107 111 122 126 132 134
107 36 37 47 72 101 117 133
108 5 6 10 12 13 15 20 30 32 34 35 40 42 44 47 49 51 52 57 58 62 70 71 83 89 91 93 97 101 104 110 111 116 117 118 119 121 125 127 130 134 135
109 9 10 16 18 31 35 37 42 56 65 69 73 80 82 84 95 103 113 116 123 124 132 135
110 1 5 12 23 24 35 36 43 52 53 69 78 101 104 107 111 119 120 123 129 131 133
111 8 20 25 30 46 51 76 82 85 95 100 102 108 134
112 1 40 54 57 70 80 88 94 102 109 117 124 126 135
113 2 3 4 7 16 18 19 20 21 28 33 35 38 40 45 46 49 52 58 63 69 71 73 74 77 78 79 80 81 82 84 85 90 91 92 99 105 112 115 116 118 119 120 121 123 126 127 130 133 135
114 1 2 6 9 10 11 13 14 15 18 19 20 22 23 24 26 29 30 31 32 33 37 38 40 41 42 43 45 47 49 51 53 56 63 64 65 66 67 71 72 77 78 79 80 81 82 84 85 86 89 90 91 93 94 96 97 99 101 103 104 106 108 109 112 113 115 116 117 118 119 121 122 123 125 126 131 135
115 2 3 5 6 8 10 12 13 14 15 22 23 25 28 30 32 33 34 35 36 37 38 40 42 43 48 49 50 52 54 55 56 57 58 59 60 61 62 63 64 66 68 69 70 71 73 74 76 78 79 80 82 84 86 89 95 96 97 99 101 105 107 108 109 110 111 112 116 118 122 124 126 129 131 134 135
116 4 6 8 9 13 17 21 27 37 39 43 51 56 57 62 64 69 73 80 82 86 90 91 93 95 96 99 104 105 106 113 120 121 122 124 125 126 127 129 135
117 4 9 13 16 27 50 61 72 74 77 83 87 96 97 101 108 112 123 124 128
118 7 16 68 74 89 108 127 133
119 5 10 11 13 14 15 18 21 22 28 29 33 38 39 41 43 44 45 46 48 51 52 53 54 59 63 66 67 69 74 75 76 77 78 85 86 88 90 96 99 104 106 114 125 129 134
120 1 3 6 7 8 11 13 14 19 21 22 26 28 29 30 31 32 36 38 39 42 44 46 47 48 50 51 54 55 56 58 59 63 65 67 68 72 73 74 75 77 78 80 81 82 83 85 87 88 89 91 93 94 95 101 104 108 109 110 112 114 115 116 118 124 125 126 127 129 130 131 132 133 134 135
121 6 9 10 14 23 24 29 30 34 45 46 50 52 54 56 59 61 70 73 75 76 80 82 88 95 97 100 107 108 114 116 117 120 131 132 135
122 1 4 8 9 12 19 25 27 31 32 36 37 38 41 42 46 49 50 53 56 64 66 67 70 72 75 79 83 85 87 91 92 93 96 98 99 100 101 102 104 107 110 113 114 115 119 121 123 125 128 131
123 4 5 6 12 26 40 44 48 63 67 68 82 83 86 88 89 96 97 110 111 112 118 121 122 126 128
124 5 7 16 25 30 32 33 36 38 47 48 52 63 64 66 73 82 84 95 99 109 123 126 133
125 58 67 97 128
126 2 3 4 5 6 10 11 12 13 14 15 18 19 22 23 24 25 28 29 30 36 38 40 42 43 48 52 53 55 56 57 58 59 61 63 65 66 70 71 72 73 74 76 78 82 87 94 95 98 100 101 105 108 109 111 115 117 118 119 121 123 124 127 130 132 135
127 10 11 12 41 70
128 4 7 8 13 14 16 19 20 21 23 25 27 29 31 33 34 37 38 40 43 44 45 46 50 56 57 60 63 64 65 68 69 70 71 72 74 75 79 80 87 89 90 91 96 97 102 103 109 124 127 129 131
129 2 3 6 16 28 35 46 54 55 56 60 69 70 77 81 87 93 102 104 109 115 118 124 128 133 134
130 15 31 40 58 67 88 89 94 115 119
131 1 3 5 6 11 14 19 20 22 26 29 34 36 43 46 47 48 52 55 57 61 62 64 71 75 76 86 89 92 93 98 100 101 103 104 109 110 120 124 128 130
132 34 39 55 74 84 86 87 88 99 112 116 121 123 127 128 131
133 4 8 12 18 22 27 28 29 32 38 44 47 49 50 53 60 62 64 65 67 76 79 83 93 94 98 105 113 115 116 123 124 128 129 130 135
134 8 11 12 16 18 19 22 24 27 29 35 36 40 41 42 44 45 46 48 56 59 66 69 71 74 77 78 81 82 84 88 90 91 93 96 97 101 105 107 108 109 112 117 121 128
135 5 20 40 44 54 71 85 129
